10 ContributorsNovember 2020 Singles Release Calendar Lyrics11/1
645AR - "Crash Out"
dante red - "movinglikeazombie (umru remix)" ft. SEBii, angelus, kmoe, Lewis Grant, savepoint, Tony Velour, emotegi, d0llywood1 & 4kmirage

11/2
Black Thought - "State Prisoner (A COLORS SHOW)"
James Vincent McMorrow - "Gone"
Pablo Alborán - "Corazón descalzo"
Paloma Mami - "For Ya"
Sarkodie - "Happy Day" ft. Kuami Eugene

11/3
Isaac Dunbar - "​miss america (brand new era)"
MAMAMOO - "Aya"
Matilda Mann - "Japan"
Oscar Lang - "Antidote to Being Bored"
Smokepurpp - "NEVER HAVE I EVER"
11/4
Cheat Codes - "Washed Up"
Jade Bird - "Headstart"
Little Mix - "Confetti"
SKAAR - "The Scientist"
11/5
Baby Queen - "Want Me"
Bree Runway - "ATM" ft. Missy Elliott
Faouzia & John Legend - "Minefields"
Hayley Mary - "The Chain"
Jehnny Beth - "Closer (Amazon Original)"
Kylie Minogue - "Real Groove"
Lukas Graham - "Where I'm From" ft. Wiz Khalifa
Maluma & The Weeknd - "Hawái (Remix)"
Sega Bodega & Låpsley - "Make U Stay"
St. Vincent - "Piggy (Amazon Original)"
Toosii - "Pain and Problems"
Trevor Jackson - "Just Friends"
11/6
2 Chainz - "Quarantine Thick" ft. Mulatto
24kGoldn - "Mood (Remix)" ft. Justin Bieber, iann dior & J Balvin
42 Dugg - "Free Woo"
88GLAM & 6ixbuzz - "East to West"
AG CLUB - "Columbia"
Amy Allen - "What a Time to Be Alive" ft. Pink Sweat$
Aries - "FOOL'S GOLD"
Armin van Buuren - "Feel Something" ft. Duncan Laurence
BENEE - "Happen to Me"
Benny Benassi & Jeremih - "LOVELIFE"
BEXEY - "HEAT OF THE MOMENT"
Bow Anderson - "Everybody Wants To Rule The World"
Buju Banton - "Come Inna The Dance"
Busy Signal - "Seen It Before"
Cuban Doll - "Talk My Shit"
D Savage - "IDC" ft. Trippie Redd
Dan + Shay - "Take Me Home For Christmas"
Digga D, Unknown T & Vybz Kartel - "Gotcha" ft. Sean D
DJ Paul & Riff Raff - Heavyweight
DREAMERS & DeathbyRomy - "True Crime"
EARTHGANG - "​Options" ft. Wale
ELIO - "hurts 2 hate somebody"
guccihighwaters - "Straight Jacket"
Hannah Grace - "Merry Christmas Everyone"
IGIR Woodiee - "Hasta Luego (Remix)" ft. Lil Durk
Ingrid Michaelson & Jason Mraz - "Christmas Valentine"
iris - "lavander and heaven"
Jackboy - "Own My Masters"
Jaebanzz - "Señorita"
JID - "Ballads" ft. Conway the Machine
J Nanks - "Crazy"
JPEGMAFIA - "Last Dance"
JUNG - "Waste My Heart"
Kap G - "Out the Mud"
KATYA - "Come In Brazil" ft. Alaska Thunderfuck
Kennedy Rd. - "Back Again"
Kid Ink - "Thick Ole"
Like Saturn - "Pink Breeze"
Lil Boom - "an evil witches love spell"
Lil Gotit - "Got It" ft. Riverknight
Lil Skies - "On Sight"
Lost Kings - "Mountains" ft. MASN
LunchMoney Lewis - "Cheat"
MC Virgins - "Trap Anthem (Acoustic Version)" ft. Yun Head
Mike WiLL Made-It - "What That Speed Bout!?" ft. YoungBoy Never Broke Again & Nicki Minaj
Mitch & YG - "Go Live"
Miley Cyrus - "Midnight Sky (Edge of Midnight)" ft. Stevie Nicks
Missy Higgins - "When the Machine Starts"
Mistah F.A.B. - "That's Him (Remix)" ft. Snoop Dogg & T.I.
Now United & R3HAB - "One Love"
Oliver Heldens & Party Pupils - "Set Me Free" ft. MAX
Omah Lay - "Damn (Remix)" ft. 6LACK
Pooh Shiesty - "Back in Blood" ft. Lil Durk
Rah Swish & DreamDoll - "Watchu Like"
Rak-Su - "Girls Like You" ft. Celina Sharma
RAYE - "Love of Your Life"
Sheff G - "Lights On"
Shordie Shordie & Murda Beatz - "Good Evening"
Swae Lee - "Krabby Step" ft. Lil Mosey & Tyga
Vado - "Checkmate" ft. Jim Jones & Dave East
VanJess - "Groove Thang"
Vivian Green - "Light Up" ft. Ghostface Killah
Working On Dying & Lancey Foux - "Off The Lead"
Yella Beezy - "On Fleek" ft. Gunna
Yemi Alafifuni - "Chains Fall"
ZenAware - "Peaks"
ZHU - "I Admit It" ft. 24kGoldn
11/7
FINNEAS - "Where the Poison Is"
Foo Fighters - "Shame Shame"
Mistah F.A.B. - "That's Him (Remix #2)" ft.  Snoop Dogg, T.I. & G-Eazy
ZieZie - "Late Night Text" ft. Ms Banks & Kwengface

11/8
Griff - "Love is a Compass"
POLKADOT STINGRAY - "化身"
11/9
French Montana - "Wave Blues" ft. BENNY THE BUTCHER

11/10
Alfie Templeman - "Shady"
Arrows in Action - "Honey"
Blac Youngsta - "Trench Bitch" ft. Lil Durk
deadmau5 & Kiesza - "Bridged By a Lightwave"
DJ Money & Wale - "Lions, Bengals & Bears (Freestyle)"
Eves Karydas - "Get Me So High"
George Maple - "Fade"
Masego & Don Toliver - "Mystery Lady"
Pale Waves - "Change"
Phoebe Bridgers - "Kyoto (Copycat Killer Version)" ft. Rob Moose
​Rico Nasty - "Oh FR"
The Antlers - "It Is What It Is"
tobi lou - "OKAY" ft. Dreezy
Wheezy - "Guillotine" ft. Future & Yo Gotti
11/11
AC/DC - "Realize"
Annabel Jones - "Spiritual Violence"
Dillon Francis - "Be Somebody" ft. Evie Irie
Do Nothing - "Glueland"
Gretta Ray & Japanese Wallpaper - "Better"
Jamie - "Apollo 11" ft. Jay Park
Kacy Hill, Electric Guest & MicahTron - "Unkind (Electric Guest Remix)"
K CAMP - "Genuine Love Freestyle"
Lava La Rue - "Angel" ft. Deb Never
Liv Dawson - "Trust Issues"
Loyle Carner - "Yesterday"
OnCue - "Big Mad"
Pouya & Rocci - "It's Over"
Sheff G - "Lights On"
Thomas Rhett - "What's Your Country Song"
Ziggy Alberts - "heartbeat"
11/12
AKTHESAVIOR - "Be Back Soon" ft. Kenneth Cash
Anne-Marie - "Problems"
Becky Hill - "Forever Young"
Billie Eilish - "Therefore I Am"
Brennan Heart & Kayzo - "Untouchable"
Cecile Believe - "Times"
chloe moriondo - "GIRL ON TV"
Crooked Colours - "Falling"
Cyn - "Uh-Oh"
Django Django - "Glowing in the Dark"
Far Caspian - "Warning Sign" ft. SOMOH
Justin Bieber - "Rockin' Around The Christmas Tree"
Katy Perry - “Resilient (ft. Aitana)[Tiësto Remix]"
Lauren Auder - "Animal"
Litany - "Uh-huh"
Loote - "Who You Are"
Mandy Moore - "How Could This Be Christmas?"
Mandy Moore - "It's the Most Wonderful Time of The Year"
Namasenda - "Wanted"
Reba McEntire & Darius Rucker - "In the Ghetto"
RMR - "The Wishing Hour"
Rod Wave - "All Week"
Run the Jewels - "No Save Point"
Slayyyter - "Throatzillaaa"
Violet Skies - "Lonely (Remix)" ft. Molly Hammar
Vlossom - "Good Karma Lover"
11/13
3OH!3 & 100 gecs - "LONELY MACHINES"
645AR - "Ride 4 You"
Alison Wonderland & Valentino Khan - "Anything"
‪Ane Brun - "Closer"
Ashton Irwin - "Heart-Shaped Box"
Asiahn - "Get Away"
Avenue Beat - "F2020 (Remix)" ft. Jessie Reyez
Bad Gyal & Juanka - "Blin Blin"
Billy Lockett - "Wasting Time"
Billy Raffoul - "Homegrown"
Billy Raffoul - "Western Skies"
Bonobo & Totally Enormous Extinct Dinosaurs - "6000 Ft."
Cavetown - "Let Me Feel Low" ft. Miloe
Celeste - "A Little Love"
City Girls - "Pussy Talk (Remix)" ft. Jack Harlow, Quavo & Lil Wayne
Conor Matthews - "Wait For Me"
Delilah Montagu - "Us"
DJ Scheme - "SODA" ft. Ski Mask the Slump God, Cordae & Take a Daytrip
Foster the People - "Under the Moon"
Fousheé - "single af"
G4 Boyz - "Prada (Remix)" ft. DreamDoll & G4choppa
Gabrielle Aplin - "Happy Xmas (War Is Over)"
Gary Barlow - "This Is My Time"
Glaive - "​eyesore"
grandson - "We Did It!!!"
HAIM - "Feel the Thunder"
Harbour - "Twenty Twenty"
Hotboii - "Goat Talk 2" ft. Polo G
​Indika Sam & ppcocaine - "Elon Musk (Remix)"
Ivy Adara - "Pressure"
James Smith - "I Don't Wanna Know"
Jay Gwuapo - "Lost Files"
Jayla Darden - "Let You Go"
Jess Glynne - "This Christmas"
Jimi Somewhere - "In My Car"
Joe Stone & Ally Brooke - "Feeling Dynamite"
Kanye West - "Nah Nah Nah (Remix)" ft. 2 Chainz & DaBaby
Kelsea Ballerini - "hole in the bottle (remix)" ft. Shania Twain
Kelly Clarkson - "All I Want For Christmas Is You"
Kid Bloom - "Hold In, Hold On"
KWAYE - "Run"
Like Saturn - "Forgetting Myself"
Lil Xan - "My Girlfriend"
Lilla Vargen - "Blueprints"
Lil Mosey - "Jumpin Out The Face"
Lil Nas X - "HOLIDAY"
Litany - "Uh-huh"
Liza Owen - "STARRY EYED"
Loski & Stormzy - "Flavour"
MORGENSHTERN - "WATAFUK?!" ft. Lil Pump
Mullally - "Lonely Too Long"
Nathan Russell - "Wait" ft. Young Tokyo & Aaron Golden
OMI - "Roller Coaster"
Passenger - "Suzanne"
Phony Ppl - "On My Shit" ft. Joey Bada$$
POORSTACY - "Nothing Left" ft. Travis Barker
Powfu & Rxseboy - "when the hospital was my home"
R3HAB & Alida - "One More Dance"
RAAHiiM - "Who Is He"
RAAHiiM - "You Love Me"
Raylee - "Unspoken"
Rexx Life Raj - "Freak" ft. Juvenile
Rich the Kid & YoungBoy Never Broke Again - "Automatic"
Russ & Ab-Soul - "Who Wants What"
Sam Feldt - "Home Sweet Home" ft. ALMA & Digital Farm Animals
Sa Vich - ''Evil Attack'' ft. A P Capone & MatthewDylan
Smoove'L - "Period."
Sorcha Richardson - "The Starlight Lounge"
StaySolidRocky - "Out Da Oven"
Steps - "Hold My Heart"
Tayla Parx - "Fixerupper"
Terror Jr - "Bloody Waters"
The Paper Kites - "Without Your Love" ft. Julia Stone
The Pretty Reckless - "25"
Tim McGraw - "Redneck Girl" ft. Midland
Tone Stith - "Devotion"
Tones and I - "Fly Away"
Transviolet & Reo Cragun - "Tropics"
TroyBoi - "Mother Africa"
twocolors - "Lovefool (Remix)" ft. Pia Mia
valentina cy - "Wind"
Working on Dying & Lucki - "Find Me"
Wynne - "In the Morning"
YNW BSlime - "Nightmares" ft. Trippie Redd
Youngs Teflon - "Old Trafford (Part 2)"
Yung Kayo - "​tell me"
Yxng Bane - "Cut Me Off" ft. D-Block Europe

11/14
Kevin Gates - "Give It All I Got"
11/15
Kevin Gates - "Amsterdam (Rooftop Luv)"
Tobe Nwigwe - "WILDLINGS" ft. DUCKWRTH & EARTHGANG

11/16
Ariel Pink - "She's Gone"
Bleachers - "45"
Bleachers - "chinatown" ft. Bruce Springsteen
Clea - "Limelight"
Dan Bull - "I'm a Zombie"
Ivan B - "Only Sometimes"
Kali Uchis & Jowell Y Randy - "te pongo mal (prendelo)"
Lil Pump - "Lil Pimp"
MoStack - "Change On Me"
11/17
Anik Khan & Jay Prince - "Lingo"
aespa - "Black Mamba"
CHINAH - "Eternal Blue"
mori_de_kurasu - "Musashino"
Mau y Ricky - "OUCH"
Poppy - "I Won't Be Home for Christmas"
RMR - "That Was Therapeutic"
​salem ilese - "Coke and Mentos"
The Jungle Giants - "In Her Eyes"
11/18
A Day to Remember - "Brick Wall"
Ali Barter - "Twisted Up"
Ani DiFranco - "Revolutionary Love"
Arlissa - "Old Love"
Biig Piig - "Feels Right"
Cautious Clay - "Dying in the Subtlety"
Dan Bull - "Mando" ft. Divide Music
girl in red - "Two Queens in a King-Sized Bed"
GRAACE - "You Do You"
Hit-Boy, Big Sean & Fivio Foreign - "Salute"
Jeezy - "Therapy For My Soul"
Joey Purp & KAMI - "Pack"
Key Glock - "All of That"
KIAN - "Sunbeam"
MARINA - "Man's World"
Petite Meller - "Dying Out of Love"
RUSSELL! - "Scarlett's Weekend"
Shame - "Water in the Well"
Sycco - "Germs"
Ten Tonnes - "Girl Are You Lonely Like Me?"
Tierra Whack - "feel good"
Tierra Whack - "Peppers and Onions"
11/19
Arctic Monkeys - "505 (Live)"
Ava Max - "My Head & My Heart"
Bay Swag - "Loyalty & Love"
Bugzy Malone - "Don't Cry" ft. Dermot Kennedy
Call Me Karizma - "Fire Escape"
Catie Turner - "One Day"
DeathbyRomy - "Come And Play With Me"
Dry Cleaning - "Scratchcard Lanyard"
Genesis Owusu - "The Other Black Dog"
Gia Ford - "This Town"
GIRLI - "Letter to My Ex"
Gryffin & Audrey Mika - "Safe With Me"
Kevin Gates & Dermot Kennedy - "Power"
Lana Del Rey - "Summertime The Gershwin Version"
Lauren Faith - "Feels"
LP - "How Low Can You Go"
MIA GLADSTONE - "FOOD"
Miley Cyrus - "Prisoner" ft. Dua Lipa
NSG - "Kate Winslet" ft.  Unknown T
Okay Kaya - "You're Still the One"
Sabrina Claudio - "Warm December"
Sasha Sloan - "Is It Just Me? (Remix)" ft. Charlie Puth
Sheck Wes - "#BEENBALLIN"
Sia - "Hey Boy"
slowthai - "nhs"
VanJess - "Slow Down"
Wale - "Flawed" ft. Gunna

11/20
451 - "Fighter Jet"
8 Graves & Unlike Pluto - "The Underground"
8ubbles - "Music is My Wife"
Anitta - "Me Gusta (Remix)" ft. Cardi B & 24kGoldn
Ann Marie & Yung Bleu - "Come Over"
Ayzha Nyree - "TLC"
Baby Goth & Slim Jxmmi - "B OK"
Beka & HONNE - "More Than Friends"
BIA - "SKATE"
Birds of Tokyo - "Weekend"
Birdy -  "Blue Skies
Black Coffee - "10 Missed Calls" ft. Jozzy & Pharrell Williams
Blithe - "Beast"
Blxst & Dom Kennedy - "Got It All"
Captain Cuts - "Stuck In My Head" ft. AJ Mitchell
Capulets - "Tribe"
Cedric Gervais & Franklin - "Everybody Dance" ft. Nile Rodgers
Charlotte Jane - "Get It Right"
Chief Keef & Mike WiLL Made-It - "Status"
CHINAH - "Promise"
Chord Overstreet - "Cold Feet"
Chris Young & Kane Brown - "Famous Friends"
CNCO - "Mis Ojos Lloran Por Ti"
Cochise - "Knicks"
Dan + Shay - "Christmas Isn't Christmas"
Dan Bull - "An Impostor Calls (Crewmate)" ft. The Stupendium
Devin Dawson - "He Loved Her"
Diplo & Sonny Fodera - "Turn Back Time"
DJ Megan Ryte - "Culture" ft. A$AP Ferg & will.i.am
Empress Of - "Broken"
Fickle Friends - "Million"
Four of Diamonds - "Never Learn My Lesson"
Frances - "Eclipse"
Frawley - "Knocking On My Heart"
G Flip - "I'D RATHER GO TO BED"
Galimatias - "Shy Dancer"
GARZI - "WILDFIRE"
​iann dior - "Holding On"
GNAR & Lil Keed & Internet Money - "HEY!"
GoldLink - "Best Rapper in the Fuckin World"
Grouplove - "Wildflowers"
Guapo & Maxo Kream - "Balenci and Dickies"
Haerts - "It's Too Late"
IDK - "2 Cents"
Isaac Dunbar - "​love, or the lack thereof"
Internet Money, Anuel AA & Gunna - "Lemonade (Latin Remix)" ft. NAV & Don Toliver
Isak Danielson - "When You Believe"
JAG, Nick Grant & Tae Beast - "2Times"
James Blake - "The First Time Ever I Saw Your Face"
Jason Derulo & Nuka - "Love Not War (The Tampa Beat)"
Jazmine Sullivan - "Pick Up Your Feelings"
Jazz Cartier - "BASEMENT"
​​johan lenox, Reo Cragun & Maya B - "the rest of our life"
Justin Jesso - "The End"
Kara Marni - "Close"
Kash Doll & DJ Infamous - "Bad Azz" ft. Benny The Butcher & Mulatto
Katelyn Tarver - "Hundred"
Kelly Rowland & NFL - "Hitman"
Kembe X - "Back At It" ft. ICECOLDBISHOP & Ab-Soul
KennyHoopla - "ESTELLA//" ft. Travis Barker
Kodie Shane - "Get to the Money" ft. Coi Leray
KSI  - "Really Love (Digital Farm Animals Remix)" ft. Yxng Bane, Tinie Tempah & Craig David
Landon Cube - "21"
Lavaado - "Can't FWU"
Lena Katina - "Nevermind"
Like Saturn - "Motion Sickness"
Lil Tjay - "Move On"
Lucy Spraggan - "Roots"
Mabel - "I'll Be Home For Christmas"
Macy Gray - "Beautiful"
Mat Kearney - "Can't Look Back"
Matt Ox - "Dazed"
Mokita & Stand Atlantic - "I'm Sorry"
Molly Brazy - "Boss Up" ft. Mozzy
Morgan Wallen - "Livin' The Dream"
Morgan Wallen - "Somebody's Problem"
Morgan Wallen - "Still Goin' Down"
Nas - "Fallen Stars Flying"
NEEDTOBREATHE - "Silent Night"
OBN Dev - "Dead Presidents"
​phem - "​stfu (remix)" ft. MASN
Quando Rondo - "End of Story"
Russell Dickerson - "It's About Time" ft. Florida Georgia Line
Sam Smith - "The Lighthouse Keeper"
Samantha Jade - "New Boy"
Sarah Barrios - "Bedroom Floor Feelings" ft. Marc E. Bassy
Shawn Mendes & Justin Bieber - "Monster"
Statik Selektah - "Play Around" ft. Allan Kingdom, Killer Mike, 2 Chainz & Conway the Machine
Stevie Jean - "Graduation"
Stunna Gambino - "Rivals (Remix)" ft. Toosii
The All-American Rejects - "Me Vs. The World"
The Stupendium - "An Impostor Calls (Impostor)" ft. Dan Bull
Tom Grennan - "Something Better"
Toosii - "Dark Fights"
VICTORIA - "Ugly Cry"
Within Temptation - "The Purge"
Wolfgang Gartner & Kill the Noise - "Battlestations"
Xavier Weeks - "Famous"
XUITCASECITY - "Cherry Red"
YBN Nahmir - "Wake Up"
Yung Baby Tate - "Rainbow Cadillac"
Yung Pinch - "Otherside"
11/21
NoCap - "Pain Show"
YoungBoy Never Broke Again - "Thug Nigga Story"
11/22
Sa Vich - ''EDM Attack'' ft. A P Capone & MatthewDylan
Tobe Nwigwe - "BOZOS" ft. Big K.R.I.T.

11/23
Arlo Parks - "Caroline"
Baby Grizzley - "Twin Grizzlies" ft. Tee Grizzley
Fred again.. - "Julia (Deep Diving)"
King Princess - "Pain"
​lilspirit - "Serpent"
11/24
Bladee & Mechatok - "God"
Bonecage - "Today's the Day You Die (Alone in Space)" ft. Dan Bull
Cordae - "The Parables"
Lights - "Deck the Halls"
Nicole Millar - "Boring!"
Saba - "So and So"
Sam Fender - "Winter Song"
Sheppard - "Solid Gold"
Steven Wilson - "12 Things I Forgot"
Teezo Touchdown - "Social Cues"
The Three Braincells - "21 24"
The Three Braincells - "ERECTILE DYSFUNCTION"
11/25
Austin Mahone - "You Got Me" ft. Frut
Iglooghost - "Eœ (Disk•Initiate)"
Indochine & Christine and the Queens - "3SEX"
Jae Stephens - "Already on It" ft. VanJess
Rina Sawayama - "LUCID"
Silver Sphere - "football game"
T9ine - "Go Harder"
Yhung T.O. - "Back Against the Wall"
YoungBoy Never Broke Again - "Let Them Shots Off"
11/26
42 Dugg - "Free Me"
D Double E & Skepta - "Don"
Jade Bird - "Houdini"
Lia Pappas-Kemps - "Object at Best"
OMB Bloodbath, Aaron May & jetsonmade - "My Dad's Fault"
Steps - "To the Beat of My Heart"
You Me at Six - "SUCKAPUNCH"
Young T & Bugsey - "New Shape"
11/27
22Gz - "Fallen Blixkys"
Alanis Morissette - "Happy Xmas (War Is Over)"
Anna Straker - "Break Up Song"
Aquilo - "Missing the Mark"
Autumn Corin - "On Your Mind" ft. DDG
Bebe Rexha - "Baby I'm Jealous (Remix)" ft. Natti Natasha & Doja Cat
BVDLVD - "D!CKHEAD"
Call Me Loop - "Rosé"
CHUNG HA & R3HAB - "Dream of You"
Church & AP - "Happy Song"
Clinton Kane - "remember the mornings"
Dan Bull - "Ana Conda"
David Shawty - "who let the dogs out"
DOPE LEMON - "Kids Fallin' In Love"
Duncan Laurence - "Arcade (Duet)" ft. FLETCHER
Eleni Foureira - "Dokisame Me"
Fivio Foreign - "Trust"
Goonew - "Bricks"
Hotboii - "No Limit"
Jennifer Lopez - "In the Morning"
JMSN - "Christmas Time Is Here"
Klingande & Wrabel - "Big Love"
LBS Kee'vin - "Toxic" ft. Luh Kel
Liam Gallagher - "All You're Dreaming Of"
Like Saturn - "stone cold"
Mark Battles, Keara Alyse & Cozz - "Try"
Myd, Mac Demarco & Bob Sinclar - "Moving Men (Bob Sinclar Remix)"
Nathan Dawe & Little Mix - "No Time for Tears"
Ola Runt - "Thanksgiving Massacre"
Qveen Herby - "Silver Bells"
RiFF RAFF, T-Pain & DJ Paul - "Say What You Want" ft. La Chat
SAINt JHN - "Smack DVD" ft. Kanye West
Sam Fischer - "For Now"
Samantha Mumba - "Cool"
Sarah Klang - "Girls"
Showtek - "Show Some Love"
Snoop Dogg - "Doggy Dogg Christmas"
The Game - "A.I. with the Braids" ft. Lil Wayne
TheHxliday - "Thank U"
TOKYO'S REVENGE - "nothinglastsforever"
Wallie the Sensei - "Scandalous (Remix)" ft. 42 Dugg
Working on Dying, Zack Fox & Father - "The Madness"
Young Franco - "Fallin' Apart" ft. Denzel Curry & Pell
Young Scooter & Zaytoven - "Dope Boys & Trap Gods" ft. Rick Ross & 2 Chainz
YoungBoy Never Broke Again - "Get Me Killed"
Young Thug - "Take It to Trial" ft. Yak Gotti
YUNGBLUD - "mars"
11/28
4 Elements - "Mi Corazon Late por Ti"
Quando Rondo - "Have You Ever"
YoungBoy Never Broke Again - "Blow Yo' Rocket"
11/29
OMB Peezy - "Still RUNNING" ft. OMB Iceberg
Tobe Nwigwe - "FATHER FIGURE" ft. Black Thought & Royce da 5'9"
YoungBoy Never Broke Again - "Rich Nigga View"
11/30
Chase Rice - "Drinkin' Beer. Talkin' God. Amen." ft. Florida Georgia Line
Fivio Foreign - "Baddie On My Wish List"
Giveon - "O Christmas Tree"
Jake Hill - "dying lately"
James Blake - "In the Bleak Midwinter"
Rotimi - "Love Somebody"
Tuxedo - "Doin' My Best" ft. Sam Swish & Gavin Turek
VIC MENSA - "BREATHE (FREESTYLE)"
YoungBoy Never Broke Again - "Spoke On Top"Embed