11 ContributorsDecember 2019 Singles Release Calendar Lyrics12/1
J.Y. Park - "FEVER"
TAEYEON - "I Do"
12/2
Alanis Morissette - "​Reasons I Drink"
Cottonwood Firing Squad - "1692"
Do Nothing - "LeBron James"
Fat Joe & Dre - "Deep"
Five Finger Death Punch - "Inside Out"
Låpsley - "Ligne 3"
NWYR - "Mind Control"
Tate Kobang - "Puddles"
Teejayx6 - "Gadgets"
The Stupendium - "The Fine Print"
Yella Beezy - "Ay Ya Ya Ya" ft. Ty Dolla $ign

12/3
Hinds - "Riding Solo"
Khruangbin & Leon Bridges - "Texas Sun"
Krewella & Nucleya - "Good on You"
Lil Poppa - "God's Hand"
Lucky Daye - "Fly"
Namasenda - "24/7"
NF - "PAID MY DUES"
Sizzy Rocket - "BODY" ft. chloe mk
Sizzy Rocket - "I KNOW WHAT U LIKE" ft. chloe mk
Tame Impala - "Posthumous Forgiveness"
Travis - "Kissing In The Wind"
Warhol.SS & Ugly God - "Top Off"
YungManny - "OMG"
12/4
Ant Clemons & Ty Dolla $ign - "Excited"
Caribou - "You and I"
Clear eyes, Drew Love & Lauren Jauregui - "Let Me Know"
Hayley Mary - "Ordinary Me"
IRIS - "Heart of an Artist"
Kali Uchis - "Solita"
12/5
Avicii - "Fades Away (Tribute Concert Version)" ft. MishCatt
Destiny Rogers - "Euphoria"
Don Toliver - "No Idea (DJ Purpberry Chopped and Screwed)"
Dounia - "GEEKED"
Flatbush Zombies - "Monica" ft. Tech N9ne
GeeYou & Young Adz - "Push Weight"
La Roux - "Gullible Fool"
Love Fame Tragedy - "Hardcore"
Nafe Smallz - "Run It Up"
Nicole Millar - "Favours"
Rico Nasty - "HARD"
Theophilus London - "Cuba"
Tommy Genesis & Jubilee - "Play With It (Jubilee Remix)"
Uffie - "Ego"
12/6
Madilyn - "Tastes Like Karma"
Madilyn - "All My Oxygen"
2KBABY - "Betta"
42 Dugg & Yo Gotti - "Bounce Back"
Adam Lambert - "Believe"
Allie X - "Love Me Wrong" ft. Troye Sivan
August Alsina - "Today"
Azizi Gibson - "5 Page Letter"
Becky Hill - "Only You"
Bugzy Malone - "December"
Chelsea Cutler - "I Was In Heaven"
City Morgue - "THE BALLOONS"
CJ Fly & Conway the Machine - "City We From"
Dave East, Jay Electronica & 070 Phi - "No Hoodie (Nothin’ To Lose)"
DC The Don - "DND Me"
Dove Cameron - "Out of Touch"
Elley Duhé - "NATURE"
Emlyn - "Had Me at Hello"
Foley - "Homesick"
G Herbo - "My Bro’s A Legend"
Gatlin - "TALKING TO MYSELF"
Grace Carter - "Amnesia"
Graham Colton - "Come Back for Nothing"
Halsey - "Finally // Beautiful Stranger"
Halsey - "Suga’s Interlude" ft.  Suga (BTS)
Harry Styles - "Adore You"
IAMDDB - "Famous"
Jack River - "Closer"
Janine - "3 AM"
Kate Stewart - "High" ft. Jevon
Lele Pons - "Vete Pa La"
Lenka - "On My Side"
Louise - "Hammer"
Martin Solveig & Roy Woods - "Juliet & Romeo"
Maurice Moore - "Water Runnin"
MELODOWNZ - "No Mercy" ft. Denzel Curry
Mike Perry - "Until I Die" ft. Joe Buck
MONSTA X - "Middle Of The Night"
Next Town Down - "This Christmas"
Niall Horan - "Put A Little Love On Me"
Nina Nesbitt - "Last December (Christmas Version)"
NLE Choppa - "Camelot (Remix)" ft. Moneybagg Yo, BlocBoy JB & Yo Gotti
Oliver Tree - "Cash Machine"
Only The Family, Lil Durk & Booka600 - "Riot" ft. G Herbo
Paige - "Too Much To H8"
Phem & Machine Gun Kelly - "Sorry mama"
Phil Good - "Put It All On Me"
Phoebe Ryan - "ICIMY"
Poundz (UK) - "Opp Thot (Remix)" ft. Tee Grizzley
Pop Smoke - "Drive The Boat"
Pussy Riot - "Hangerz" ft. JUNGLEPUSSY & Vic Mensa
Quinn Lewis - "One of Us"
Rak-Su - "Girl"
Rich The Kid - "That’s Tuff" ft. Quavo
Robokid - "2003" ft. Slayyyter
SASSY 009 - "Lara" ft. Clairo
Sean Price & Lil Fame - "Center Stage"
Smokepurpp - "Audi II"
Steve Aoki, Sting & SHAED - "2 In A Million"
Taylor Swift - "Christmas Tree Farm"
Teyana Taylor - "We Got Love"
The Kelseys - "Something Else"
The Kid LAROI. - "Let Her Go"
Wes Period - "Nü Shoes"
Yung Pinch - "Sober"
Zack Fox - "The Bean Kicked In"
Zaytoven, Lil Yachty & Lil Keed - "Accomplishments"
12/7
Akachi - "PRETTYBOY!" ft. Joey Trap & TOKYO'S REVENGE

12/9
Kaytranda - "10%" ft. Kali Uchis
Nick Cannon - "The Invitation" ft. Prince Eazy, Charlie Clips, Hitman Holla & Suge Knight
Okay Kaya - "Asexual Wellbeing"
12/10
Cam’ron - "Big Deal"
Cub Sport - "Hearts in Halves"
Jay Critch - "Dreams In A Wraith"
NLE Choppa - "Famous Hoes"
Paloma Mami - "Mami"
Quando Rondo - "Collect Calls"
Rod Wave - "Misunderstood"
Sam Fender - "All Is On My Side"
Yumi Zouma - "Right Track / Wrong Man"
12/11
Chris Webby - "Forged In Fire"
Elijah Yo - "3 Deep"
Leven Kali - "Homegirl" ft. Topaz Jones & Smino
Lil Toe - "Tick Tock"
MGMT - "In the Afternoon"
Ocean Alley - "Tombstone"
Ocean Grove - "SUNNY"
Poppy - "Fill the Crown"
RiFF RAFF - "Husky"
Smokepurpp - "What I Please" ft. Denzel Curry
12/12
Alec Benjamin - "Mind Is A Prison"
Ava Max - "Salt"
Baauer & Channel Tres - "Ready to Go" ft. Danny Brown
Carly Rose - "Warned you"
Denzel Curry - "Alienz" ft. YBN Cordae
Ducko McFli - "40 Bandz" ft. Jace & Denzel Curry
Kesha - "Resentment" ft. Brian Wilson & Sturgill Simpson
Ladyhawke - "Colours In The Dark"
Macklemore - "It’s Christmas Time" ft. Dan Caplen
Mavi Phoenix - "Boys Toys"
Phoebe Bridgers - "7 O’Clock News / Silent Night" ft. Matt Berninger & Fiona Apple
slowthai - "I Need"
Tommy Genesis & Charli XCX - "Bricks"
YoungBoy Never Broke Again - "Dirty Iyanna"
12/13
070 Shake - "Under The Moon"
Alec King - "7PM"
Alicia Keys - "The Christmas Song"
Bad Gyal - "Zorra"
BEXEY - "Eternal Flow"
Bryant Myers - "Low Key"
Clinton Kane - "So I Don’t Let Me Down"
DC The Don - "Rock Out"
Delacey - "No One’s Gonna Ever Love U"
DEVIN MØRE - "1986"
Diplo & SIDEPIECE - "On My Mind"
Don Toliver - "Can’t Feel My Legs"
Dounia - "Love-Showered"
DP Beats - "BVNDZ" ft. Chief Keef
Dua Lipa - "Future Nostalgia"
Emma Jensen - "Someone to Break Your Heart"
FINNEAS - "I Lost a Friend (Marian Hill Remix)"
G Herbo - "Remember"
Gabrielle Aplin - "Magic"
Goonew - "Suicidal Thoughts"
GRAACE - "Overthink"
Grimes - "4Æm"
​guccihighwaters - "High school"
Hayley Kiyoko - "runaway"
Jake Paul - "These Days"
Jay Sean - "Lonely"
Joey Trap - "Arrival"
John Baumann - "Love’s a Word I Never Throw Around"
Jonas Blue & 陳梓童 (Tifa Chen) - "Billboard"
Jordan Solomon - "Lost Myself"
K CAMP - "Ice Cold"
Kamaiyah - "Still I Am"
Kwesta - "I Came I Saw" ft. Rick Ross
Kyle Dion - "Stay the Night"
Leadley - "23"
Lil Tjay - "Go In"
Lil Uzi Vert - "Futsal Shuffle"
Lil West - "Pay Me (Remix)" ft. Night Lovell
Louis The Child, Naomi Wild & Couros - "Here Comes a Feeling"
Maroon 5 & Dillon Francis - "Memories (Dillon Francis Remix)"
Meghan Trainor - "Evil Twin"
Moses Sumney - "Polly"
Nause & Rebecca & Fiona - "Can't Erase"
Night Lovell - "LETHAL PRESENCE"
NLE Choppa - "Side"
OBN Dev - "Bulletproof"
Pop Smoke - "100K On The Coupe" ft. CalBoy
RAYE - "Please Don't Touch"
Rayy Dubb - "Beat It Up"
Ricky Remedy - "Rockstar" ft. Stoop Lauren & Pe$o
Russ - "NIGHTTIME (Interlude)"
SOB X RBE - "Ain’t Got Time"
Sofia Carson & R3HAB - "I Luv You"
StayLoose & Last Heroes - "Won't Look Back" ft. Soundr
​svrite - "Haha"
Tadoe & Chief Keef - "One Mo"
The Score - "Bulletproof" ft. XYLØ
The Voidz - "Did My Best"
TOMM¥ €A$H - "Sdubid"
Travis Barker, Lil Wayne & Rick Ross - "Gimme Brain"
Twelve’len - "Loyal"
Usher​​ - "Don’t Waste My Time" ft. Ella Mai
Wande Coal - "Ode Lo Like"
wifisfuneral - "Peace Sign" ft. YBN Nahmir
Yellow Claw - "El Terror" ft. Lil Toe & Jon Z
ZZ Ward - "Sex & Stardust"
12/14
DAGames - "Press Start Together"
12/15
Amir Obè - "Silver Lining"
Lil Tecca - "Why U Look Mad"
12/16
Lil Esco 28 - "Ight Imma Fuck Witcha" ft. RobThePlayboy

12/17
Cub Sport - "City of Angels"
Kenny Mason - "Angelic Hoodrat"
Lauren Sanderson - "To The People I Hurt"
Lil Blurry & Yung Tory - "Calling My Line"
12/18
Eli Sostre - "Trustin You" ft. 451
Gucci Mane - "Jingle Bales"
Jacob Latimore - "Don’t Wanna Leave" ft. Mulatto
Lucky Daye - "Roll Some Mo (Remix)" ft. Wale & Ty Dolla $ign
Machine Gun Kelly - "why are you here"
ViiC FlaiR - "Somebody To Love" ft. John Gabbana

12/19
Bombay Bicycle Club - "Racing Stripes"
Mozzy - "Wicked" ft. SG ALI

12/20
36nokutz - "Tre Inna 20" ft. Hoodrich Pablo Juan
$UICIDEBOY$ - "Fuck Your Culture"
$UICIDEBOY$ - "Scope Set"
CalBoy - "Purpose" ft. G Herbo
Dax - "Dear Santa"
DC The Don - "Do You Feel Me"
Fetty Wap - "Fresh n Clean"
Jacy - "Run It Up" ft. Joey Trap
Joey Trap - "Howdy"
Kevin Powers - "New Drip" ft. YSB Eli & YSB Tril
Kid Ink - "FCUKIZYOUDOIN"
KILLY - "Vendetta"
LiQuin - "Another One" ft. Lil Keed
Luh Kel - "Close To Me"
MDMA - "Blood Shower"
OBN Dev - "Bin Reaper"
Quin NFN - "Crash Dummy"
Sam Tompkins - "Not So Grey"
Secrets - "Myself, My Mind, and I"
Sigma - "Sell My Soul" ft. Maverick Sabre
​tobi lou - "Uncle Iroh"
Xavier Weeks - "TEAM (Remix)" ft. Luh Kel
YSN Flow - "Bounty Hunters" ft. YSN Jayo
Yung Mal - "Stashed In The Vent"
12/21
G4 Boyz - "Local Scammer" ft. G4choppa

12/22
Blueface - "Finesse The Beat"
Darko & JordanxBell - "AMNESIA"
12/23
16yrold & Killy - "Drought"
Burna Boy - "Money Play"
Ed Sheeran & Travis Scott - "Antisocial - Ghali Remix" ft. Ghali
Kehlani - "All Me" ft. Keyshia Cole
Yung Pinch - "Over It" ft. Wiz Khalifa

12/24
Drake - "War"
12/25
Anly - "愛情不足"
KILL.ZERO - ":NIGHTMARES AWAIT.. i’m not sleepy anymore."
ohtrapstar - "Polar Bear"
The Secret Sisters - "Hold You Dear"
12/27
Alan Walker & Ava Max - "Alone, Pt. II"
DJ Snake, J Balvin & Ozuna - "Loco Contigo (Remix)" ft. Darell, Sech, Natti Natasha & Nicky Jam
Don Toliver - "Had Enough" ft. Offset & Quavo
Eva Shaw, Thouxanbanfauni & Nate Husser - "Strip"
J Hus - "No Denying"
lil ricefield, zé rosé & ‎seiji oda - "Based Students"
Martin Garrix & Matisse & Sadko - "Hold On" ft. Michel Zitron
Philthy Rich - "Hard Times"
Vybz Kartel - "Super Soca" ft. Machel Montano

12/30
Ava Max - "On Somebody"
Why Don't We - "Chills"
12/31
Lil Boom - "GOODWILL DRIP"2Embed