4 ContributorsApril 2022 Singles Release Calendar Lyrics4/1Aaron Dews - "Peace of Mind"
Alishia Monroe - "Long Way" ⏳
Andrew Ripp - "The Lord's Prayer"
Anh Thai - "3am"
Anne Wilson - "God Thing"
Anthony Evans - "House of the Lord"
Austin Joyce - "Don't Let Me Go" feat. Henrik ⏳
Ben Lawrence & JSteph - "THE REASON"
Calvary Worship - "We Will Remember" feat. Jabari Johnson ⏳
CAMPBELL - "Where the Light Is" feat. Jervis Campbell & Nancy Daines
CANDIACE - "Win" ⏳
Cara Davis - "Heaven Is Coming To Earth" feat. Imani Taalib
City Movement & Unified Sound - "Live Like This" ⏳
Colorvault & Young Oceans - "Sweet Silence"
DAMIAN - "In Your Arms" ⏳
Dante Bowe - "Nail Scarred Hands"
Dany Mark - "Me Entrego" feat. Nancy Moran ⏳
Dawson Samuel - "Wake Me Up"
Destiny Worship Music - "Welcome the King"
Gas Street Music - "Foundations (Live)" feat. Luke Hellebronth
Essential Worship - "Mighty"
Jeremiah Coyne - "Whole Heart"
Jesús Adrián Romero - "¿Cómo Me Ves?"
Jimmy McNeal - "Don't Move That Mountain" ⏳
JKO & Saint James - "Far Away"
John Michael Howell - "American Dream" ⏳
Jonathan Ogden - "Living Water"
Judikay - "Satisfied"
Kojo Dave, 24ldz & Rehmahz - "Jo" ⏳
Life.Church Worship - "Finished Work of Christ"
Limoblaze - "Ife Wami" feat. 121SELAH
Lindy Cofer & Circuit Rider Music - "Christ And Christ Crucified (Live)" feat. Mitch Wong
Lindy Cofer & Circuit Rider Music - "Christ And Christ Crucified (Spontaneous) [Live]" ⏳
Majo y Dan & Marcos Brunet - "Probar y Verte / Deseo Eterno"
Matt Maher & Lizzie Morgan - "Leaning"
Micah Bournes - "By Now (live)" ⏳
Michael W. Smith - "Cry for Hope"
Mission - "Be Gone" feat. Mike Teezy ⏳
Mountaintops - "Everything That Has Breath" feat. TEMITOPE ⏳
Musumba - "Abc" ⏳
Musumba - "Everything" ⏳
Novelle - "Fade (With You)"
Providence - "When I Survey the Wondrous Cross" ⏳
ReFRESH Worship - "Seek Your Face" feat. Ryan Avery
Shelley E. Johnson - "The Lion Still Roars"
simplyollie - "SHEKHINAH GLORY"
Small Sounds - "Little One"
Solomon Headen - "OSCAR." ⏳
ST-Saint, R-Scar & Reblah - "Call Your Name" ⏳
The Porter's Gate - "Declaring Glory (The Earth Sings its Refrain)" feat. Jon Guerra, Audrey Assad & Page CSVI
The Sound - "God Is Real"
The Worship Initiative - "Trinity Song (Live)" feat. Aaron Williams, John Marc Kohl & Dinah Wright
Tk Lee - "Not Today" feat. 1K Phew ⏳
Todd Tilghman - "Worth It All" feat. Rita Springer
Tom Read - "05 (Morning)"
Tori Harper - "Let Me In"
Travis Cottrell - "The Kindness Of The Cross"
Trombone Shorty - "What It Takes" feat. Lauren Daigle
United Pursuit - "Ave, Amity" feat. Brock Human
Unspoken - "Loved By You"
Via Music - "Only Got Love" ⏳
Wild Earth - "Hope For Me"4/3Jessy Elsa Palma - "How do you know"4/4Becca VanDerbeck, Matthew Heath & Noel Goff - "How Can I Say This Now" feat. FLOY ⏳4/5Aable & IMRSQD - "Tell Me"
Karissa Frampton - "Stupid Things" ⏳
Nitro X - "REALITY" ⏳
Salmodio - "A Palavra"4/6Christafari - "Brand New" feat. Henna Melody4/7Celine Hales - "You Care" feat. James Gruntz
Nós em Um - "Caminho"
Rubinsky Rbk - "Te Amo"
Sam&Steff - "OH YOUR GOODNESS"
Streetlights & Prisims - "Don't Look Down" ⏳
TJ Carroll - "Eastside Southside"4/8Alexander Reign - "Like You"
Amanda Cook - "Miracle of the Mind"
Aryn Michelle - "Pariah"
Becca Jordan - "Ordinary, Everyday Love" ⏳
BigGucciDame & ohsobrkn - "Shine" ⏳
Billy Ballenger - "Close to You"
BrvndonP & Mission - "Trophy Gvng"
Bryan McCleery - "Bigger Than Impossible (Live)" ⏳
Building 429 - "Worry"
Byron Rhodes & Fvmeless - "Swim Lessons"
Calvary Worship - "Righteous Royalty" feat. Nicholas Traylor & Ben Dailey ⏳
Cecily - "Dear Future Husband" ⏳
Chandler Moore, Phil Wickham & Maverick City Music - "Worthy of My Song" feat. Mav City Gospel Choir
Cody Ray Lee - "Left My Heart" feat. Skylar Dayne
Coop & NXTMIKE - "UNDER CONSTRUCTION" ⏳
C3 Toronto Worship - "Thank You Jesus"
Destiny Marko - "Estás Tú" feat. Chris Rocha
DJLC & Jack Tyler - "That's on GOD" ⏳
Don Ryvcko - "Tu Sonrisa" ⏳
Emissary - "With You"
FAITHFUL - "A Woman (Live)" feat. Amy Grant & Ellie Holcomb ⏳
Harborside Music - "Te Dejo Entrar" ⏳
Hillsong UNITED - "Blown Away"
Hillsong UNITED - "God Song"
Hillsong UNITED - "Show Me Your Heart"
IMRSQD, Moflo Music & Lj the Messenger - "Poison"
John Mark McMillan - "Atlanta"
John Van Deusen - "Be Not Far From Here"
John Van Deusen - "Uninspired, Blowing Smoke"
Jonathan Turner - "One Name"
Jor'dan Armstrong & Erica Campbell - "CALL"
Jordan Marcotte - "No One Else"
Katy Weirich - "Just One"
Kelsey Geminden - "I Trust You"
Kenny Rivers - "GUERREANDO" ⏳
Keremy Caro - "Hechos 2" ⏳
Leah McFall - "Eden"
LifePoint Music - "Left Here Undone (Live)" feat. TEMITOPE & Jordan Strickland ⏳
LIN D - "Wings" ⏳
Manor Collective - "Thank You, Sorry, Please" feat. Becca Folkes, Charlotte Kiwanuka & Elle Limebear
METRUTH - "It'll Be Okay" feat. Christian Singleton & Kumiko Bankson
Midway Music - "Empty Grave" feat. Ben McAdams
Morrissa Nicole - "Thank You for the Cross (Acoustic Version)" ⏳
MUCH MORE - "wastin'" ⏳
Oversoon - "Reflection" feat. Mackenzie Paige ⏳
planetboom - "I Will Follow You (Live)"
Rachael Lampa - "Perfectly Loved" feat. TobyMac
Reed Deming - "more for me" ⏳
Rehmahz, Bridge Music & Asha Elia - "Easy" ⏳
Sarah Sings - "At Your Feet" feat. Ps. Isaiah Fosu-Kwakye Jnr ⏳
Seryn - "Misery"
Shanta Fuentes - "All In" ⏳
Spencer Annis - "Coming Clean"
Swingin Hammers - "Tremble"
Tatiana Manaois - "I Adore You" ⏳
Tauren Wells - "Empty"
Taylor Armstrong - "la la la"
The Group Fire - "Anything but Fail" ⏳
Watashi Wa - "Zombie" feat. Anberlin
Xay Hill & Patrick McMillan - "Heartless" ⏳
Yvonne Hartman - "The Moment I'm In" ⏳
Zach Paradis - "West Coast"4/10hadassa morais - "he's not a one-night stand kind of lover, love, gomer"
Verses - "Psalm 22:1-2" feat. Jessica Fox4/11CityAlight - "This Is the Day"
Darling We're Dancing We've Been Liberated - "Hail"
Lance Blake - "My Child" ⏳
SIV & Moflo Music - "Get Lost"4/12almost a.m. - "Honorable Mention"
A3 - "INAU" feat. Not Klyde ⏳
Brie Stoner - "Bloom" ⏳
Evelyn Wanjiru - "Asante" ⏳
J. Monty & TuKool Tiff - "Enemies and Foes"
Lowsan Melgar & Musiko - "Corazón de Piedra" ⏳4/13Poor Bishop Hooper - "Psalm 120"
Rebekah Renatus & Arrow - "Good Company" feat. Nu Tone & muted mike ⏳
Samuel Ribeiro - "Aprendiz"4/14Brian Doerksen - "Mind of Christ (Philippians 2)" feat. Steve Mitchinson ⏳
Common Hymnal - "The Revival" feat. Phillip Joubert
Futures - "Cast My Cares"
Gigi Moss - "Three Words"
John O & Swoope - "We Go On" feat. Solomon Headen & Ashley Merrell ⏳
Joshua Parkin - "We Are Warriors" ⏳
Kevin Downswell - "Grace"
Madison Street Worship - "Treasure" feat. Harley Rowell
Maximilian - "Falling In Love Again"
Ministério F4ces - "Saudade de Cristo"
Vancouver Sleep Clinic - "The Flow"4/15Aaron Kell - "Breeze" ⏳
Art Of Dying - "Sweet Emotion" ⏳
Be Amplified & Anaysha Figueroa-Cooper - "Not Forgotten" ⏳
Black Voices Movement & Circuit Rider Music -  "Behold (The King Is Calling) [Live]" feat. Lindy Cofer & Alvin Muthoka
Brett Raio, Paul Hernandez & Aubree Renee - "I Pray" ⏳
Bryan & Katie Torwalt - "Good News (Live)"
Byron Rhodes & Fvmeless - "Break Bread" ⏳
Caleb Carroll - "Authentic Love" ⏳
Crystal Lewis - "She Was Here" feat. Tori Kelly
Dany Gray, Kurist Hoppie, Raw-B & Xay Hill - "NONSENSE"
DJ Mykael V, Scootie Wop & Wxlf - "BURBERRY COAT!"
Dr Tumi - "You Deserve It" ⏳
Fellowship Creative - "Man of Miracles (Live)"
Former Ruins - "Doxology" ⏳
Former Ruins - "Sparrow Eyes" ⏳
Futures - "In Your Eyes"
George García - "Aquella vez"
GIDYON, Rehmahz & A Mose - "KING of 'kings"" ⏳
Ginny Owens - "Yet Not I But Through Christ In Me"
gio. - "burn for u" ⏳
Guilherme Leite - "O Peso da Cruz" ⏳
Haynza - "RIP 2 ME"
Icon For Hire - "Ready For Combat"
Jekasole - "VOICES" ⏳
Jet Trouble - "Where To Find Me" ⏳
John Michael Howell - "Is Pluto A Plannet?" ⏳
Jonathan Baily - "Golden" ⏳
Jonathan Ogden - "Low"
Jon Webster - "Midnight"
Jordan Marcotte - "Thank You"
Joseph Goulding & MASO - "Love Is Patient" feat. Kai Uriah ⏳
Joshua's Giants - "Like Lazarus" feat. Jesse Cash ⏳
Jubril - "Good Morning" ⏳
Kenny Rivers - "A LAS NUBES" ⏳
Ki Alexis - "Repair My Heart" ⏳
Kinnship - "Shower Me"
Kleber Lucas - "Jesus, Te Amo" ⏳
Leah Rose - "Jericho" ⏳
Lifepoint Worship - "All" ⏳
Local Sound - "Time And Time Again"
Lord Badu - "RANSOM" feat. Kojo Dave & PG Prod ⏳
Manafest - "Brain Dead"
Masterkraft - "Hosanna" feat. chike
MEMPHIS BLOOD - "Parallel" ⏳
Mike Teezy - "Rolled the Stone Away"
Noah Paul Harrison - "98"
O'Bros - "Bis in den Tod"
Rachael Nemiroff - "Secrets"
Ravenhill - "SHINE A LIGHT" ⏳
RAY G, OnBeatMusic & Dillon Chase - "What's the Move?" ⏳
Reblah, Shirlvin Desir & J1W - "Messiah" ⏳
Ross Millet - "MAYBE I'M CRAZY" feat. MvkeyyJ
Ryan Ellis - "All My Praise"
Sam Rivera - "Let Go"
Savannah Gibson - "Home"
seni. - "Follow" ⏳
Shelly E. Johnson - "God of Tomorrow"
Shevelle - "Testimony"
shxrda - "I LOVE U GOD"
SONS THE BAND - "Crowns"
SoulBox - "Nobody Like You" ⏳
Supernova - "Outro Lado" feat. Gesse & Lion Braga ⏳
TC - "Little Saint" feat. BRM & Hugh Holla ⏳
The Consolation - "Easy"
The Shelter & Bernice West - "High Calling" ⏳
The Sound - "I Didn't Find Jesus"
the Story Collective - "Welcome to Story Church" feat. Evan Ford, Sam Collier, 1ne Chance & Constance Mack ⏳
Tatiana Manaois - "Down That Hill" ⏳
TAYA - "All Eyes On You"
Temple Dior - "Focus" ⏳
Tommy Royale - "Abba" ⏳
Travis Ryan - "He's Alive" ⏳
Tribl & Maverick City Music - "King of Heaven (Reign Jesus Reign)" feat. Ryan Ofei, Nate Diaz & Lizzie Morgan
Uninvtd & S A I N T - "Strawberry Worship"
VOUS Worship - "In The Morning "for V"" ⏳
Wild Earth - "This Is Glory" feat. Lovkn ⏳
William Murphy - "Just Us"
WorshipNOIZ - "Emmanuel: Yahvé Shamma" ⏳
Zach Paradis - "Lost My Baby" feat. BigBreeze ⏳
ZION Worship - "Lighthouse" ⏳
Zyrius - "My Hope" ⏳
5ive - "Old Me" feat. Thi'sl & Derek Minor4/16Futures - "Behold"4/17fbp.worship - "よみがえられた"
Futures - "Death Is Defeated (Just Like That)"
GONZO HERNAN & Praise Lubangu - "TRUST ME" ⏳
Igor Felix & Flavio Vitor Jr. - "Reconstituir" ⏳
Kingdomcity - "Taste And See" ⏳
Toyosi Oseni - "Hosanna" ⏳4/18Jonny Hayes - "Open Up"4/19Asher Livingston - "Open Arms" ⏳
Kings Kaleidoscope, "Wasn't I Worth It?"4/20Lovd Ones & Benjah - "Great Escape" ⏳
Poor Bishop Hooper - "Psalm 121"4/21Arik Nelson - "Grace" ⏳
Darla Baltazar - "Ain't The First Time"
Tracy Nitschke - "Thank God!" ⏳4/22alli ward - "kindness" ⏳
Amongst Wolves - "I'd Be Lying To Myself"
Ben Lawrence & Cole Tindal - "I GIVE UP" ⏳
Carmen Justice - "Green" ⏳
Colorvault - "With Us Still" feat. Alex Taylor
Corey Voss - "Hold On"
Cutright - "Playground" ⏳
Daniel Doss - "Revival"
Dara Maclean - "My Deliverer" feat. Chi Chi Onyekanne
Davey Asaph - "One Billion Things" ⏳
David Leonard - "Good Lord"
Dee-1 & Reconcile - "I-10 East" ⏳
Emily Faith - "Space"
ENY - "Something More"
Ethan Nathaniel & Taylor Armstrong - "All Things New" ⏳
Evan Craft, KB & Sam Rivera - "Be Alright (Remix)"
From the Ash & 39th Avenue - "Paralyzed"
Futures - "Just The Cross"
Gateway Worship - "Behold Him Now (Live)" feat. Anna Byrd
Gatton & Maximillian - "When Scars Become Art II"
ICF Worship - "Faithful God"
Igor Montenegro - "Final Feliz"
Jacques Miché - "Rb." ⏳
Jake Layne - "Love Like This" ⏳
jaylen. & ohsobrkn - "CALL U BACK" ⏳
Jemimah Paine & Eva Swanson - "Beloved" ⏳
Jillian Edwards - "Sweet Disposition"
Jonathan David Middleton - "Future Years" ⏳
Josh Holsey - "Save The Day" ⏳
Joshua Luke Smith & Wild Sons - "Father" ⏳
Justin Rizzo - "Come Now Joy (Live)"
Karima - "It's Alright To Cry" ⏳
Ken Gober - "Either Way"
Kurtis Hoppie & WEARETHEGOOD - "Underdogs"
Matthew West - "Wonderful Life"
Maurice Kirya - "Sejjiga" ⏳
Mere Vessels - "Clouded Mirror"
Mitch Wong - "Pentecost"
Nick Schrader - "We Cannot Worry"
Oba Reengy - "His Own" ⏳
OLY - "Burning in the Rain"
People Of Hope - "Good to Me"
Phil Wickham - "Worthy of My Song"
Right Hand Shade - "Hindsight"
River Valley Worship - "Thank You Lord (Live)"
Rob Ray - "Never Would Have Guessed" ⏳
Ryan Brockington - "Divine Time"
Saint James - "Caught Up"
Sammy Nino - "Chase the Giver"
Scootie Wop - "BOOM!"
SEMAJE - "You"
Shades - "In My Wandering"
Silas Magalhães & Asha Elia - "Come and Be My Love" ⏳
S.O. - "MAKE IT MAKE SENSE" ⏳
The Jonah Project - "Psalm 73"
TEMITOPE - "ANYWHERE EVERYWHERE" feat. Lucas & Evelyn Cortazio ⏳
Titus & Matt Mogg - "Killing Me" ⏳
Via Music - "Come Through" feat. Garrett Mahoney
Watashi Wa - "How Will We Live?" feat. Matthew Thiessen ⏳
WEARETHEGOOD - "Came For It All" feat. Roy Tosh & George.Rose ⏳
We, The Saints - "Footsteps" ⏳
We Will Worship - "We The Forgiven" feat. Stella
Whitefield - "Hurricane" ⏳
Wolrus WORSHIP & Gayana - "Не оставишь" ⏳
YJKL & CRFT - "Time"
YUILA - "Tanz mit mir" ⏳4/24Jonathan Lawes - "Every Day"
New Creation Worship - "Everlasting" ⏳4/25Caleb Russel Kennedy - "Rest (Original Recording)"
Hyper Fenton - "On Purpose" ⏳4/26YB - "STILL GOING" ⏳4/27Poor Bishop Hooper - "Psalm 122"
REVERE & Central 3 - "Infinito Amor"4/28Andrez Babii - "123 Enemies"
George.Rose - "ADLIBS" ⏳
Jimmy Cheo - "Deeper In My Heart (Home Recording)" ⏳
Kingholyan Miraculous - "Hello" ⏳
Kingholyan Miraculous - "keep Going" ⏳
Kingholyan Miraculous - "Protected" ⏳
Ocean - "Escape" ⏳4/29Aaron Cole - "Hard Times" feat. Mali Music ⏳
Agnieszka Musiał - "Zasypiają ćmy"
Alvin Cedric - "Remedy" feat. Aria Alise
Amanda Cook - "Where the War Ends"
Anmily Brown - "Para Mi" ⏳
Anna Golden - "Take It To Jesus"
Armand Mukenge & Mbushka - "Places (Des Endroits)" ⏳
Atrade & Xay Hill - "Easier" feat. Joseph Goulding & Coastside ⏳
BELOVED - "Branch & Vine"
Ben Fuller - "Wide Awake"
Ben Laine - "I Found God"
BigGucciDame & Kai Uriah - "Fomo" ⏳
Brady James - "Get A Life"
Brandon Lake - "HELP!"
Caleb Mitchell - "Blue"
CAMPBELL - "Let's Go Home" feat. Jervis Campbell
Canyon Hills Worship - "On And On"
Cecily - "Momma Kinda Lovin" ⏳
Colton Dixon - "Build a Boat"
Crystal Aikin - "Trouble Don't Last" ⏳
David Hernandez - "Sé que me amas"
dooda, melo & Amen Worldwide - "el pan de cada dia" ⏳
Drew Miller - "New Wine" ⏳
Ealle & A Mose - "Emotions" ⏳
Emilio Sarabia - "Power Trip" ⏳
Emissary - "I'll Be Your Guide"
Eversmith - "Serenity"
Gas Street Music & Nick Herbert - "Come and Have Your Way (Live)"
Gil Joe - "Provider" feat. CalledOut Music ⏳
I AM THEY - "Firm Foundation (He Won't)"
Isaias Baquedano - "Satisfy"
James David William - "O Father"
Jason Crabb - "Good Morning Mercy"
Jessy - "Pilgrimage" ⏳
John Jin Han - "YOUTH (spring)" feat. Jonathan Ogden
John Lucas - "Doing the Best We Can" ⏳
John Mark McMillan - "Awake in the Dream"
John Van Deusen - "Oh Sweetest Name"
John Van Deusen - "You Tell Me"
Jonathan Ashenafi - "my soul"
Jonny Hayes - "Birds"
Ka'i Lasit - "Enough For Nobody" ⏳
KB - "King Jesus (Pt. II)" feat. Big Breeze, Scootie Wop, 1K Phew, Mike Teezy, Limoblaze, Wande, Cardec Drums, Tommy Royale & S.O.
Kierre Bjorn - "Little Seed" feat. Naomi Raine
Lauren Talley - "Shut Him Up" ⏳
Legin - "Stop" ⏳
Leon Timbo - "Never Too Much" ⏳
Loyal Love - "His Eye Is On The Sparrow" ⏳
Luke Garfield - "Hallowed"
Maddie Rey - "Name's Sake" ⏳
Matthew Campbell - "Lay It All Down" feat. Jace Richardson
Maverick City Musica & Maverick City Music - "Cómo Te Amamos" feat. Karen Espinosa & Johnny Peña
Nathan Taylor - "My Story" feat. Vincent McNatt
Neon Adejo - "Free" ⏳
Neon Feather & Trampolines - "FUTUREGLOW" ⏳
New City Collective & Stored in my Heart - "How Sweet Are Your Words (Psalm 119:101-104)" feat. Dave Aubrey & Lindsey Lerro ⏳
Noontides - "Miracles"
O Bairro Novo - "Louvor IV" feat. Joyce Carnassale ⏳
Patricia Romania e Delino Marçal - "Apenas Canção"
Paul the Messenger - "Chaos"
PEABOD - "Alive"
Relena-Rochelle - "Say Less"
Ri-An & Philippa Hanna - "How Great Thou Art" ⏳
RIDERS & Circuit Rider Music - "PRIORITIES"
Rob Nightingale - "Who Is Like Our God"
Seth Carpenter - "No One Was"
Shelly E. Johnson - "Still On His Throne"
SONNY OH! - "Color Me Crazy" feat. O.M.G
Tasha Layton - "How Far"
Taylor Marshall - "Casting Call"
Taylor Pride - "Rescue Mission" ⏳
The Union of Sinners and Saints - "We Are The Broken" ⏳
The Young Escape - "Landslide"
Tobias Runeson - "A Clean Heart" ⏳
Torey D'Shaun & nobigdyl. - "CATFISH"
Vocal Livre, Pedro Valença e Ventania.us - "Dias de Paz"
Wild Earth - "Peace Be With You"
YouthFR - "Parfaitement imparfait"4/30Corbin York - "Hold My Breath" ⏳
Dirk - "The Other Side" ⏳
Lagoinha Music & Gabe Marchesi - "Vida Morte Eternidade"Embed