2 ContributorsEvery Anthony Fantano Review LyricsCURRENTLY UNFINISHED2010:• Gorillaz - "Plastic Beach" (STRONG 7)
• The Knife - "Tomorrow, in a Year" (LIGHT 3)
• High on Fire - "Snakes for the Divine" (DECENT 8)
• Liars - "Sisterworld" (STRONG 6)
• Broken Bells - "Broken Bells" (LIGHT 5)
• Arckanum - "ÞÞÞÞÞÞÞÞÞÞÞ" (STRONG 8)
• Gonjasufi - "A Sufi and a Killer" (LIGHT 9)
• Portugal. The Man - "American Ghetto" (STRONG 3)
• MGMT - "Congratulations" (STRONG 7-LIGHT 8)
• The Morning Benders - "Big Echo" (LIGHT 6)
• Autechre - "Oversteps" (STRONG 5-LIGHT 6)
• Jónsi - "Go" (DECENT-STRONG 6)
• Black Tambourine - "Black Tambourine" (LIGHT 7)
• Burzum - "Belus" (STRONG 4-LIGHT 5)
• Titus Andronicus - "The Monitor" (STRONG 7)
• The Tallest Man On Earth - "The Wild Hunt" (STRONG 8)
• Iggy and the Stooges - "Raw Power (Legacy Edition)" (LIGHT 5)
• Caribou - "Swim" (STRONG 6-LIGHT 7)
• Happy Birthday - "Happy Birthday" (STRONG 5-LIGHT 6)
• Various Artists - "Pomegranates" (STRONG 8)
• Darkthrone - "Circle the Wagons" (DECENT-STRONG 5)
• Crystal Castles - "Crystal Castles (II)" (STRONG 6-LIGHT 7)
• Brokеn Social Scene - "Forgivenеss Rock Record" (LIGHT-DECENT 4)
• Flying Lotus - "Cosmogramma" (STRONG 7-LIGHT 8)
• Little Woman - "Throat" (LIGHT 9)
• Holy Fuck - "Latin" (DECENT 7)
• The National - "High Violet" (STRONG 6)
• Woods - "At Echo Lake" (LIGHT 8)
• The New Pornographers - "Together" (LIGHT 7)
• The Dead Weather - "Sea of Cowards" (STRONG 5)
• LCD Soundsystem - "This Is Happening" (DECENT 9)
• The Black Keys - "Brothers" (STRONG 6-LIGHT 7)
• Sleigh Bells - "Treats" (LIGHT 3)
• Harlem - "Hippies" (DECENT-STRONG 7)
• TOBACCO - "Maniac Meat" (STRONG 6-LIGHT 7)
• Xasthur - "Portal of Sorrow" (STRONG 4)
• Ratatat - "LP4" (LIGHT 8)
• Guilty Simpson - "OJ Simpson" (STRONG 5-LIGHT 6)
• Tame Impala - "Innerspeaker" (STRONG 6-LIGHT 7)
• Melvins - "The Bride Screamed Murder" (DECENT 5)
• Sleepy Sun - "Fever" (STRONG 7-LIGHT 8)
• Here We Go Magic - "Pigeons" (STRONG 6-LIGHT 7)
• Ariel Pink’s Haunted Graffiti - "Before Today" (LIGHT 8)
• Suckers - "Wild Smile" (7)
• The Drums - "The Drums" (LIGHT 8)
• Foals - "Total Life Forever" (LIGHT 4)
• Villagers - "Becoming a Jackal" (STRONG 6)
• The Radio Dept. - "Clinging to a Scheme" (DECENT-STRONG 8)
• Devo - "Something for Everybody" (DECENT-STRONG 6)
• Uffie - "Sex Dreams and Denim Jeans" (LIGHT 2)
• Janelle Monáe - "The ArchAndroid" (STRONG 8-LIGHT 9)
• Laurie Anderson - "Homeland" (STRONG 8)
• Emeralds - "Does It Look Like I’m Here?" (STRONG 5-LIGHT 6)
• Various Artists - "Cloud Cuckooland" (DECENT 7)
• Wolf Parade - "Expo 86" (STRONG 6-LIGHT 7)
• The Roots - "How I Got Over" (STRONG 8-LIGHT 9)
• Wavves - "King of The Beach" (CHILL 8)
• Club 8 - "The People’s Record" (LIGHT-DECENT 5)
• Big Boi - "Sir Lucious Left Foot... The Son of Chico Dusty" (LIGHT 6)
• Noveller - "Desert Fires" (DECENT-STRONG 7)
• Superhumanoids - "Urgency" (LIGHT 8)
• Dirty Projectors & Björk - "Mount Wittenberg Orca" (LIGHT 8)
• M.I.A. - "/\/\ /\ Y /\" (STRONG 5)
• The Books - "The Way Out" (LIGHT 9)
• Baths - "Cerulean" (LIGHT 8)
• Mono/Poly - "Paramatma" (STRONG 6-LIGHT 7)
• Best Coast - "Crazy For You" (STRONG 5-LIGHT 6)
• Wild Nothing - "Gemini" (LIGHT 7)
• Danger Mouse & Sparklehorse - "Dark Night of the Soul" (NO SCORE)
• Arcade Fire - "The Suburbs" (STRONG 8)
• Ceremony - "Rohnert Park" (LIGHT 8)
• Daughters - "Daughters" (DECENT 8)
• The Budos Band - "The Budos Band III" (STRONG 5-LIGHT 6)
• Autolux - "Transit Transit" (STRONG 6)
• Various Artists - "Afro​-​Beat Airways - West African Shock Waves - Ghana & Togo 1972​-​1978" (STRONG 8)
• Thou - "Summit" (STRONG 7)
• Iron Maiden - "The Final Frontier" (LIGHT-DECENT 6)
• Teen Daze - "Four More Years" (STRONG 6-LIGHT 7)
• Sufjan Stevens - "All Delighted People EP" (DECENT 8)
• Matmos & So Percussion - "Treasure State" (DECENT-STRONG 6)
• Klaxons - "Surfing the Void" (STRONG 3-LIGHT 4)
• Mogwai - "Special Moves" (DECENT-STRONG 8)
• Magik Kids - "Memphis" (STRONG 7-LIGHT 8)
• Interpol - "Interpol" (DECENT-STRONG 5)
• Miami Horror - "Illumination" (STRONG 6-LIGHT 7)
• Watain - "Lawless Darkness" (LIGHT-DECENT 6)
• Tera Melos - "Patagonian Rats" (STRONG 5)
• Weezer - "Hurley" (LIGHT-DECENT 7)
• ​of Montreal - "False Priest" (LIGHT 5)
• Blonde Redhead - "Penny Sparkle" (LIGHT 8)
• Grinderman - "Grinderman 2" (DECENT 7)
• The Walkmen - "Lisbon" (DECENT-STRONG 5)
• Chromeo - "Business Casual" (LIGHT 9)
• Future Islands - "In Evening Air" (DECENT-STRONG 7)
• Black Milk - "Album of the Year" (LIGHT 4)
• Black Mountain - "Wilderness Heart" (DECENT 6)
• Flying Lotus - "Pattern + Grid World" (LIGHT 8)
• Swans - "My Father Will Guide Me Up a Rope to the Sky" (STRONG 6)
• Deerhunter - "Halcyon Digest" (STRONG 8)
• Nails - "Unsilent Death" (FACE-PUNCHING, HEAD-CRUSHING 9)
• No Age - "Everything in Between" (LIGHT-DECENT 6)
• Neil Young - "Le Noise" (ON THE FENCE 5)
• Women - "Public Strain" (LIGHT 9)
• SALEM - "King Night" (STRONG 2)
• The Tallest Man On Earth - "Sometimes the Blues Is Just a Passing Bird" (LIGHT-DECENT 8)
• Abe Vigoda - "Crush" (STRONG 4-LIGHT 5)
• Twin Shadow - "Forget" (BEEFY 8)
• Mark Ronson & The Business Intl - "Record Collection" (ALRIGHT 5)
• Sufjan Stevens - "The Age of Adz" (STRONG 6)
• Belle and Sebastian - "Write About Love" (STRONG 5-WEAK 6)
• The Fresh & Onlys - "Play It Strange" (STRONG 4-LIGHT 5)
• Luke Abbott - "Holkham Drones" (DECENT 8)
• Sharon Van Etten - "epic" (HEYCOOLCHECKTHISOUT 7)
• Avey Tare - "Down There" (LIGHT 5)
• The Gaslamp Killer - "Death Gate" (STRONG 7)
• Kings of Leon - "Come Around Sundown" (DECENT-STRONG 4)
• Zach Hill - "FACE TAT" (LIGHT 5)
• Matthew Dear - "Black City" (DECENT-STRONG 7)
• Warpaint - "The Fool" (STRONG 6-LIGHT 7)
• DIAMOND RINGS - "Special Affections" (LIGHT-DECENT 8)
• Squarepusher - "Shobaleader One: d’Demonstrator" (STRONG 5-LIGHT 6)
• Bongripper - "Satan Worshipping Doom" (STRONG 8-LIGHT 9)
• Small Black - "New Chain" (NO SCORE)
• How to Dress Well - "Love Remains" (STRONG 3-LIGHT 4)
• Electric Wizard - "Black Masses" (DECENT-STRONG 6)
• Brian Eno - "Small Craft on a Milk Sea" (LIGHT-DECENT 8)
• Das Racist - "Shut Up, Dude" (LIGHT 6)
• Das Racist - "Sit Down, Man" (DECENT 8)
• Kid Cudi - "Man on the Moon II: The Legend of Mr. Rager" (STRONG 5-LIGHT 6)
• Gold Panda - "Lucky Shiner" (STRONG 6-LIGHT 7)
• Matt and Kim - "Sidewalks" (NO SCORE)
• CeeLo Green - "The Lady Killer" (STRONG 7)
• Weekend - "Sports" (LIGHT 8)
• Teebs - "Ardour" (STRONG 6)
• Kanye West - "My Beautiful Dark Twisted Fantasy" (LIGHT-DECENT 6)
• Agalloch - "Marrow of the Spirit" (DECENT 8)
• Girl Talk - "All Day" (LIGHT 8)
• Girls - "Broken Dreams Club" (STRONG 5)
• Glasser - "Ring" (STRONG 8-LIGHT 9)
• Maserati - "Pyramid of the Sun" (STRONG 7-LIGHT 8)
• OFF! - "First Four EPs" (DECENT-STRONG 8)
• Daft Punk - "TRON: Legacy (Original Motion Picture Soundtrack)" (STRONG THIS IS A PRETTY FREAKIN COOL SOUNDTRACK YOU SHOULD CHECK IT OUT IF YOU'RE INTO SCORES I'M NOT REALLY BUT I HAVE TO RECOGNIZE IMPRESSIVE PRODUCTION AND INSTRUMENTATION WHEN I HEAR IT YEAH IT'S PRETTY COOL THING YOU SHOULD HEAR IT)
• Tyler, The Creator - "Bastard" (STRONG 7-LIGHT 8)
• Tonetta - "777" (DECENT 6)
• Skrillex - "Scary Monsters and Nice Sprites" (LIGHT 7)
• Kids & Explosion - "Shit Computer" (STRONG 8-LIGHT 9)
• Anika - "Anika" (STRONG 3)
• Röyksopp - "Senior" (STRONG 5-LIGHT 6)
• The Souljazz Orchestra - "Rising Sun" (DECENT 8)
• Ghostface Killah - "Apollo Kids" (STRONG 7-LIGHT 8)
• Big Blood - "Dark Country Magic" (DECENT-STRONG 7)
• Gorillaz - "The Fall" (DECENT 5)
• Shad - "TSOL" (STRONG 6-LIGHT 7)2011:• M.I.A. - "Vicki Leekx" (DECENT-STRONG 6)
• JJ - "kills" (STRONG 2-LIGHT 3)
• All Pigs Must Die - "All Pigs Must Die" (STRONG 6-LIGHT 7)
• CAKE - "Showroom of Compassion" (DECENT 7)
• Wire - "Red Barked Tree" (DECENT-STRONG 5)
• Sea Power - "Valhalla Dancehall" (LIGHT 8)
• Cage The Elephant - "Thank You, Happy Birthday" (LIGHT 5)
• Ghost - "Opus Eponymous" (STRONG 8-LIGHT 9)
• A-1 - "After School Special" (DECENT-STRONG 7)
• Smith Westerns - "Dye It Blonde" (LIGHT-DECENT 7)
• White Lies - "Ritual" (STRONG 4-LIGHT 5)
• Fergus & Geronimo - "Unlearn" (LIGHT 8)
• Deerhoof - "Deerhoof vs. Evil" (DEERHOOF WON)
• Destroyer - "Kaputt" (LIGHT 9)
• The Decemberists - "The King Is Dead" (LIGHT 4)
• Iron & Wine - "Kiss Each Other Clean" (MAYBEALIKEA 6 OR SOMETHING)
• Kvelertak - "Kvelertak" (STRONG 8)
• Braids - "Native Speaker" (LIGHT-DECENT 7)
• John Vanderslice - "White Wilderness" (STRONG 6)
• Dumbo Gets Mad - "Elephants at the Door" (STRONG 7-LIGHT 8)
• Earth - "Angels of Darkness, Demons of Light I" (LIGHT-DECENT 7)
• Cut Copy - "Zonoscope" (STRONG 5-LIGHT 6)
• James Blake - "James Blake" (STRONG 7-LIGHT 8)
• Natural Child - "Natural Child 7"" (LIGHT 8)
• Mogwai - "Hardcore Will Never Die, But You Will" (LIGHT 8)
• Lil B - "Angels Exodus" (STRONG 2-LIGHT 3)
• Andy D - "Songs In The Key Of Magic" (DECENT WHATEVER)
• Vreid - "V" (STRONG 6-LIGHT 7)
• Nicolas Jaar - "Space Is Only Noise" (DECENT-STRONG 8)
• Radiohead - "The King of Limbs" (LIGHT-DECENT 6)
• Colin Stetson - "New History Warfare, Vol. 2: Judges" (STRONG 8)
• Toro y Moi - "Underneath the Pine" (STRONG 6-LIGHT 7)
• PJ Harvey - "Let England Shake" (STRONG 8-LIGHT 9)
• Fashawn - "Higher Learning Vol. 2" (STRONG 6)
• Yuck - "Yuck" (STRONG 5)
• Siriusmo - "Mosaik" (DECENT-STRONG 7)
• The Mountain Goats - "All Eternals Deck" (LIGHT 8)
• Beady Eye - "Different Gear, Still Speeding" (DECENT-STRONG 3)
• Weedeater - "Jason... The Dragon" (DECENT-STRONG 7)
• Tim Hecker - "Ravedeath, 1972" (LIGHT 8)
• Lupe Fiasco - "Lasers" (STRONG 3-LIGHT 4)
• Raekwon - "Shaolin vs. Wu-Tang" (STRONG 5-LIGHT 6)
• Burzum - "Fallen" (DECENT-STRONG 6)
• Reks - "Rhythmatic Eternal King Supreme" (DECENT-STRONG 8)
• The Strokes - "Angles" (STRONG 6-LIGHT 7)
• The Pains of Being Pure at Heart - "Belong" (LIGHT 8)
• Craft Spells - "Idle Labor" (LIGHT 8)
• Bibio - "Mind Bokeh" (STRONG 5)
• Big K.R.I.T. - "Return of 4Eva" (DECENT 9)
• Trap Them - "Darker Handcraft" (DECENT-STRONG 7)
• Panda Bear - "Tomboy" (STRONG 4-LIGHT 5)
• Holy Ghost! - "Holy Ghost!" (DECENT 8)
• The Vaccines - "What Did You Expect from the Vaccines?" (DECENT-STRONG 6)
• Timber Timbre - "Creep On Creepin’ On" (LIGHT 8)
• TV on the Radio - "Nine Types of Light" (STRONG 6-LIGHT 7)
• The Weeknd - "House of Balloons" (STRONG 3-LIGHT 4)
• Crystal Stilts - "In Love With Oblivion" (STRONG 8-LIGHT 9)
• Metronomy - "The English Riviera" (STRONG 7)
• Foo Fighters - "Wasting Light" (STRONG 6)
• Rotten Sound - "Cursed" (5)
• Wormrot - "Dirge" (8)
• Tune-Yards - "w h o k i l l" (LIGHT 7)
• The Kills - "Blood Pressures" (STRONG 4-LIGHT 5)
• Bill Callahan - "Apocalypse" (DECENT-STRONG 6)
• CunninLynguists - "Oneirology" (LIGHT-DECENT 8)
• Beastie Boys - "Hot Sauce Committee Part 2" (STRONG 8-LIGHT 9)
• Explosions in the Sky - "Take Care, Take Care, Take Care" (STRONG 5-LIGHT 6)
• Fleet Foxes - "Helplessness Blues" (LIGHT-DECENT 9)
• The Antlers - "Burst Apart" (STRONG 4-LIGHT 5)
• Death Grips - "Exmilitary" (DECENT 8)
• Tyler, The Creator - "Goblin" (STRONG 4-LIGHT 5)
• Wild Beasts - "Smother" (DECENT-STRONG 7)
• The Lonely Island - "Turtleneck and Chain" (5 8====Ds)
• Liturgy - "Aesthethica" (STRONG 8)
• Manchester Orchestra - "Simple Math" (STRONG 4-LIGHT 5)
• Jesu - "Ascension" (LIGHT 5)
• Amon Tobin - "ISAM" (DECENT-STRONG 7)
• The UV Race - "Homo" (LIGHT 8)
• This Will Destroy You - "Tunnel Blanket" (STRONG 6-LIGHT 7)
• Balkans - "Balkans" (STRONG 7-LIGHT 8)
• ​eLZhi - "eLmatic" (DECENT-STRONG 8)
• Lady Gaga - "Born This Way" (NO SCORE)
• Boris - "Heavy Rocks" (STRONG 6-LIGHT 7)
• Boris - "Attention Please" (LIGHT 4)
• Coma Cinema - "Blue Suicide" (DECENT-LIGHT 7)
• Master Musicians of Bukkake - "Totem 3" (STRONG 7)
• My Morning Jacket - "Circuital" (STRONG 5-LIGHT 6)
• Theophilus London - "Lovers Holiday" (LIGHT-DECENT 8)
• Death Cab for Cutie - "Codes and Keys" (LIGHT 7)
• Havok - "Time Is Up' (STRONG 8-LIGHT 9)
• Planningtorock - "W" (STRONG 1-LIGHT 2)
• Woods - "Sun and Shade" (STRONG 5-LIGHT 6)
• Arctic Monkeys - "Suck It and See" (STRONG 4-LIGHT 5)
• Snake Oil - "Snake Oil" (LIGHT 7)
• Battles - "Gloss Drop" (LIGHT-DECENT 9)
• Fucked Up - "David Comes To Life" (STRONG 4-LIGHT 5)
• Poor Lily - "Poor Lily" (LIGHT 8)
• WU LYF - "Go Tell Fire to the Mountain" (STRONG 5-LIGHT 6)
• Blood Ceremony - "Living With the Ancients" (DECENT-STRONG 7)
• Bad Meets Evil - "Hell: The Sequel" (STRONG 6-LIGHT 7)
• Bon Iver - "Bon Iver, Bon Iver" (LIGHT-DECENT 6)
• Iceage - "New Brigade" (STRONG 8-LIGHT 9)
• SBTRKT - "SBTRKT" (LIGHT-DECENT 8)
• Cults - "Cults" (STRONG 3-LIGHT 4)
• Shabazz Palaces - "Black Up" (DECENT 8)
• Samiyam - "Sam Baker’s Album" (LIGHT 5)
• Lil B - "I’m Gay (I’m Happy)" (LIGHT 0)
• Herman Düne - "Strange Moosic" (STRONG 6-LIGHT 7)
• Ulcerate - "The Destroyers of All" (DECENT-STRONG 7)
• Limp Bizkit - "Gold Cobra" (NO SCORE)
• Kendrick Lamar - "Section.80" (LIGHT-DECENT 8)
• Washed Out - "Within and Without" (STRONG 6-LIGHT 7)
• The Horrors - "Skying" (LIGHT 7)
• Zombi - "Escape Velocity" (STRONG 7-LIGHT 8)
• Touché Amoré - "Parting the Sea Between Brightness and Me" (DECENT-STRONG 7)
• The Cool Kids - "When Fish Ride Bicycles" (STRONG 4)
• Toxic Holocaust - "Conjure and Command" (DECENT-STRONG 8)
• Portugal. The Man - "In The Mountain In The Cloud" (DECENT-STRONG 6)
• They Might Be Giants - "Join Us" (STRONG 5-LIGHT 6)
• Little Dragon - "Ritual Union" (LIGHT-DECENT 8)
• MellowHype - "BlackenedWhite (Re-release)" (LIGHT-DECENT 6)
• Unknown Mortal Orchestra - "Unknown Mortal Orchestra" (STRONG 5-LIGHT 6)
• Machinedrum - "Room(s)" (STRONG 6)
• Hudson Mohawke - "Satin Panthers" (STRONG 7)
• Theophilus London - "Timez Are Weird These Days" (NO SCORE)
• Various Artists - "Brand New Wayo - Funk, Fast Times & Nigerian Boogie Badness 1979-1983" (DECENT 7)
• Beirut - "The Rip Tide" (STRONG 5-LIGHT 6)
• JAY-Z & Kanye West - "Watch the Throne" (STRONG 5-LIGHT 6)
• Matana Roberts - "Coin Coin Chapter One: Gens de couleur libres" (LIGHT-DECENT 8)
• Cerebral Ballzy - "Cerebral Ballzy" (STRONG 3-LIGHT 4)
• Rival Sons - "Pressure & Time" (DECENT-STRONG 7)
• Chelsea Wolfe - "Ἀποκάλυψις" (DECENT-STRONG 8)
• The War on Drugs - "Slave Ambient" (DECENT-STRONG 6)
• Africa Hitech - "93 Million Miles" (DECENT-STRONG 8)
• Active Child - "You Are All I See" (DECENT-STRONG 6)
• Danny Brown - "XXX" (LIGHT-DECENT 8)
• Apathy - "Honkey Kong" (LIGHT-DECENT 7)
• Giles Corey - "Giles Corey" (LIGHT-DECENT 8)
• Red Hot Chili Peppers - "I’m with You" (STRONG 5-LIGHT 6)
• Lil Wayne - "Tha Carter IV" (LIGHT-DECENT 3)
• Hella - "Tripper" (STRONG 6)
• Shlohmo - "Bad Vibes" (DECENT-STRONG 7)
• The Drums - "Portamento" (STRONG 5-LIGHT 6)
• Girls - "Father, Son, Holy Ghost" (LIGHT-DECENT 7)
• Thundercat - "The Golden Age Of Apocalypse" (STRONG 7-LIGHT 8)
• The Men - "Leave Home" (LIGHT 6)
• Wolves in the Throne Room - "Celestial Lineage" (LIGHT-DECENT 6)
• St. Vincent - "Strange Mercy" (LIGHT-DECENT 8)
• Neon Indian - "Era Extraña" (LIGHT-DECENT 3)
• Das Racist - "Relax" (STRONG 5-LIGHT 6)
• Veronica Falls - "Veronica Falls" (LIGHT 8)
• AJJ - "Knife Man" (DECENT-STRONG 8)
• Opeth - "Heritage" (LIGHT-DECENT 5)
• Wild Flag - "Wild Flag" (DECENT-STRONG 7)
• Mastodon - "The Hunter" (STRONG 5-LIGHT 6)
• BADBADNOTGOOD - "BBNG" (STRONG 7-LIGHT 8)
• J. Cole - "Cole World: The Sideline Story" (STRONG 6)
• 9th Wonder - "The Wonder Years" (STRONG 4-LIGHT 5)
• Future Islands - "On the Water" (LIGHT-DECENT 6)
• Wilco - "The Whole Love" (DECENT-STRONG 7)
• Teenage Cool Kids - "Denton After Sunset" (STRONG 7-LIGHT 8)
• La Dispute - "Wildlife" (DECENT-STRONG 8)
• James Blake - "Enough Thunder" (STRONG 4-LIGHT 5)
• Mr. Muthafuckin eXquire - "Lost in Translation" (NO SCORE)
• Feist - "Metals" (DECENT-STRONG 4)
• Rustie - "Glass Swords" (DECENT-STRONG 7)
• Civil Civic - "Rules" (DECENT-STRONG 7)
• Absu - "Abzu" (LIGHT-DECENT 8)
• Kuedo - "Severant" (STRONG 6-LIGHT 7)
• M83 - "Hurry Up, We’re Dreaming" (STRONG 4-LIGHT 5)
• Tom Waits - "Bad as Me" (STRONG 6-LIGHT 7)
• The Field - "Looping State of Mind" (DECENT-STRONG 7)
• Justice - "Audio, Video, Disco." (STRONG 5-LIGHT 6)
• Black Milk & Danny Brown - "Black and Brown!" (STRONG 7)
• ​milo - "I wish my brother Rob was here" (LIGHT 8)
• ​Oblivionized - "Abhorrent Evolution" (LIGHT-DECENT 8)
• ​Lou Reed & Metallica - "Lulu" (LIGHT-DECENT 6)
• The Strange Boys - "Live Music" (LIGHT 7)
• A$AP Rocky - "LIVE.LOVE.A$AP" (STRONG 7-LIGHT 8)
• My Brightest Diamond - "All Things Will Unwind" (LIGHT-DECENT 6)
• Ghoul - "Transmission Zero" (DECENT 8)
• David Lynch - "Crazy Clown Time" (LIGHT-DECENT 5)
• Childish Gambino - "Camp" (STRONG 2-LIGHT 3)
• Atlas Sound - "Parallax" (DECENT-STRONG 6)
• Pianos Become the Teeth - "The Lack Long After" (STRONG-DECENT 6)
• Drake - "Take Care" (STRONG 6-LIGHT 7)
• Crystal Stilts - "Radiant Door" (DECENT-STRONG 6)
• King Krule - "King Krule" (STRONG 7)
• Wale - "Ambition" (STRONG 4)
• Mac Miller - "Blue Slide Park" (STRONG 4-LIGHT 5)
• Cynic - "Carbon-Based Anatomy" (STRONG 7-LIGHT 8)
• Kate Bush - "50 Words for Snow" (DECENT-STRONG 7)
• Vektor - "Outer Isolation" (STRONG 8-LIGHT 9)
• The Log.Os - "Λόγος" (DECENT 8)
• The Spits - "Vol.V" (LIGHT-DECENT 6)
• Yelawolf - "Radioactive" (LIGHT 5)
• Red Horse - "Red Horse II" (STRONG 6-LIGHT 7)
• Oneohtrix Point Never - "Replica" (LIGHT-DECENT 8)
• Comet Gain - "Howl of the Lonely Crowd" (DECENT-STRONG 7)
• The Black Keys - "El Camino" (STRONG 5-LIGHT 6)
• Jacaszek - "Glimmer" (DECENT-STRONG 7)
• Nujabes - "Spiritual State" (STRONG 6-LIGHT 7)
• Cormorant - "Dwellings" (DECENT 8)
• The Roots - "undun" (NO SCORE)
• Cass McCombs - "Humor Risk" (STRONG 6)
• Godspeed You! Black Emperor - "Lift Your Skinny Fists Like Antennas to Heaven" (NO SCORE)
• Frank Zappa - "Hot Rats" (NO SCORE)
• Wu-Tang Clan - "Enter the Wu-Tang (36 Chambers)" (NO SCORE)
• Marvin Gaye - "What’s Going On" (NO SCORE)
• Neutral Milk Hotel - "In the Aeroplane Over the Sea" (NO SCORE)2012:• The Internet - "Purple Naked Ladies" (STRONG 3-LIGHT 4)
• Guided by Voices - "Let’s Go Eat the Factory" (STRONG 6)
• The Weeknd - "Echoes of Silence" (DECENT-STRONG 8)
• Zammuto - "Idiom Wind" (LIGHT 7)
• Alcest - "Les Voyages De l'âme" (LIGHT 5)
• Charlie Haden & Hank Jones - "Come Sunday" (STRONG 6-LIGHT 7)
• The Act of Estimating As Worthles - "Amongst These Splintered Minds // Leaden Thoughts Sing Softly" (DECENT-STRONG 7)
• Cloud Nothings - "Attack on Memory" (STRONG 7-LIGHT 8)
• ScHoolboy Q - "Habits & Contradictions" (STRONG 5)
• Young Fathers - "Tape One" (STRONG 7-LIGHT 8)
• First Aid Kit - "The Lion’s Roar" (DECENT-STRONG 7)
• Gonjasufi - "MU.ZZ.LE" (STRONG 6)
• Chairlift - "Something" (LIGHT-DECENT 7)
• Lamb of God - "Resolution" (STRONG 3)
• Pop. 1280 - "The Horror" (LIGHT 7)
• Heems - "Nehru Jackets" (LIGHT 8)
• Lana Del Rey - "Born to Die" (STRONG 3-LIGHT 4)
• The Maccabees - "Given to the Wild" (STRONG 5-LIGHT 6)
• John Talabot - "Fin" (STRONG 7-LIGHT 8)
• Loma Prieta - "I.V." (STRONG 8-LIGHT 9)
• ​of Montreal - "Paralytic Stalks" (DECENT-STRONG 7)
• ​Leonard Cohen - "Old Ideas" (STRONG 4-LIGHT 5)
• ​A Place to Bury Strangers - "Onwards to the Wall" (STRONG 5-LIGHT 6)
• Shlohmo - "Vacation" (STRONG 7-LIGHT 8)
• Sharon Van Etten - "Tramp" (DECENT-STRONG 7)
• Lapalux - "When You’re Gone" (DECENT-STRONG 6)
• Portico Quartet - "Portico Quartet" (STRONG 8-LIGHT 9)
• Earth - "Angels of Darkness, Demons of Light II" (STRONG 5-LIGHT 6)
• Burial - "Kindred" (STRONG 8)
• Tennis - "Young & Old" (STRONG 4-LIGHT 5)
• Goatwhore - "Blood for the Master" (DECENT-STRONG 7)
• Grimes - "Visions" (DECENT-STRONG 5)
• Perfume Genius - "Put Your Back N 2 It" (STRONG 8-LIGHT 9)
• Sleigh Bells - "Reign of Terror" (STRONG 5-LIGHT 6)
• Pallbearer - "Sorrow and Extinction" (DECENT-STRONG 7)
• Christian Mistress - "Possession" (LIGHT 8)
• WZRD - "WZRD" (STRONG 2-LIGHT 3)
• Evian Christ - "Kings And Them" (STRONG 6-LIGHT 7)
• Big K.R.I.T. - "4Eva N a Day" (DECENT-STRONG 8)
• The Magnetic Fields - "Love at the Bottom of the Sea" (DECENT-STRONG 5)
• The Men - "Open Your Heart" (STRONG 7)
• Soap&Skin - "Narrow" (STRONG 7-LIGHT 8)
• Odd Future - "The OF Tape Vol. 2" (LIGHT-DECENT 4)
• Unsane - "Wreck" (STRONG 6-LIGHT 7)
• THEESatisfaction - "awE naturalE" (DECENT 8)
• The Shins - "Port of Morrow" (STRONG 5-LIGHT 6)
• The Mars Volta - "Noctourniquet" (DECENT-STRONG 7)
• Daniel Rossen - "Silent Hour/Golden Mile" (LIGHT 8)
• Meshuggah - "Koloss" (LIGHT-DECENT 6)
• Zammuto - "Zammuto" (LIGHT-DECENT 8)
• High on Fire - "De Vermis Mysteriis" (STRONG 8-LIGHT 9)
• BADBADNOTGOOD - "BBNG2" (STRONG 8-LIGHT 9)
• Chromatics - "Kill for Love" (STRONG 4-LIGHT 5)
• Willis Earl Beal - "Acousmatic Sorcery" (STRONG 3-LIGHT 4)
• Kindness - "World, You Need a Change Of Mind" (DECENT-STRONG 7)
• Dr. John - "Locked Down" (STRONG 7)
• Lotus Plaza - "Spooky Action at a Distance" (STRONG 5-LIGHT 6)
• Black Dice - "Mr. Impossible" (STRONG 5-LIGHT 6)
• Spiritualized - "Sweet Heart Sweet Light" (LIGHT-DECENT 8)
• Quakers - "Quakers" (STRONG 4-LIGHT 5)
• Moonface and Siinai - "Heartbreaking Bravery" (STRONG 6-LIGHT 7)
• Death Grips - "The Money Store" (STRONG 9-10)
• Battles - "Dross Glop" (STRONG 5-LIGHT 6)
• Jack White - "Blunderbuss" (DECENT-STRONG 6)
• White Suns - "Sinews" (STRONG 7-LIGHT 8)
• Actress - "R.I.P." (STRONG 5-LIGHT 6)
• Torche - "Harmonicraft" (LIGHT-DECENT 8)
• ​billy woods - "History Will Absolve Me" (LIGHT-DECENT 8)
• The Flaming Lips - "The Flaming Lips and Heady Fwends" (STRONG I WISH TIME MACHINES EXISTED SO THAT I COULD GO BACK IN TIME AND FORCE MYSELF TO BUY THIS ON VINYL LIKE I SHOULD HAVE ON RECORD STORE DAY)
• Dweller on the Threshold - "Vol. I" (LIGHT-DECENT 6)
• OFF! - "OFF!" (DECENT-STRONG 7)
• Lone - "Galaxy Garden" (DECENT-STRONG 8)
• B.o.B - "Strange Clouds" (STRONG 4-LIGHT 5)
• ​mewithoutYou - "Ten Stories" (STRONG 6)
• Beach House - "Bloom" (STRONG 8-LIGHT 9)
• Squarepusher - "Ufabulum" (LIGHT-DECENT 6)
• Ab-Soul - "Control System" (LIGHT-DECENT 8)
• Mac Miller - "Macadelic" (NO SCORE)
• Marilyn Manson - "Born Villain" (STRONG 3-LIGHT 4)
• Killer Mike - "R.A.P. Music" (DECENT-STRONG 8)
• DOPE BODY - "Natural History" (STRONG 8-LIGHT 9)
• Best Coast - "The Only Place" (LIGHT 3)
• Mount Eerie - "Clear Moon" (STRONG 7-LIGHT 8)
• Cerce - "Tour Sampler CD-R" (DECENT-STRONG 7)
• El-P - "Cancer 4 Cure" (DECENT-STRONG 6)
• Sigur Rós - "Valtari" (LIGHT 7)
• Big K.R.I.T. - "Live from the Underground" (STRONG 6-LIGHT 7)
• Black Breath - "Sentenced to Life" (LIGHT 8-DECENT 8)
• Japandroids - "Celebration Rock" (STRONG 5-LIGHT 6)
• Neil Young & Crazy Horse - "Americana" (LIGHT-DECENT 7)
• Liars - "WIXIW" (STRONG 7-LIGHT 8)
• Recondite - "On Acid" (LIGHT-DECENT 8)
• The Tallest Man On Earth - "There’s No Leaving Now" (DECENT-STRONG 8)
• ​iamamiwhoami - "kin" (DECENT-STRONG 8)
• Clams Casino - "Instrumentals 2" (DECENT-STRONG 7)
• Kreator - "Phantom Antichrist" (STRONG 5)
• Suns - "The Engine Room" (STRONG 7-LIGHT 8)
• Joey Bada$$ - "1999" (DECENT-STRONG 7)
• Fiona Apple - "The Idler Wheel Is Wiser Than the Driver of the Screw and Whipping Cords Will Serve You More Than Ropes Will Ever Do" (STRONG 8-LIGHT 9)
• Bobby Womack - "The Bravest Man in the Universe" (STRONG 6)
• Curren$y - "The Stoned Immaculate" (STRONG 2-LIGHT 3)
• Metric - "Synthetica" (STRONG 3-LIGHT 4)
• The Smashing Pumpkins - "Oceania" (DECENT-STRONG 6)
• Open Mike Eagle - "4NML HSPTL" (DECENT-STRONG 7)
• Ty Segall & White Fence - "Hair" (LIGHT 8)
• Ty Segall Band - "Slaughterhouse" (LIGHT-DECENT 8)
• Old Man Gloom - "No" (DECENT-STRONG 6)
• Hot Chip - "In Our Heads" (STRONG 7-LIGHT 8)
• SpaceGhostPurrp - "Mysterious Phonk: The Chronicles of SpaceGhostPurrp" (STRONG 5-LIGHT 6)
• Rush - "Clockwork Angels" (LIGHT-DECENT 6)
• Dirty Projectors - "Swing Lo Magellan" (LIGHT-DECENT 6)
• H-SIK - "Cocody" (STRONG 7)
• Foxygen - "Take the Kids Off Broadway" (DECENT 8)
• Twin Shadow - "Confess" (STRONG 4-LIGHT 5)
• Frank Ocean - "channel ORANGE" (DECENT-STRONG 7)
• Baroness - "Yellow & Green" (DECENT-STRONG 7)
• Wreck and Reference - "No Youth" (DECENT-STRONG 7)
• Nas - "Life Is Good" (STRONG 3-LIGHT 4)
• Holograms - "Holograms" (LIGHT-DECENT 8)
• Aesop Rock - "Skelethon" (STRONG 7-LIGHT 8)
• Mission of Burma - "Unsound" (LIGHT-DECENT 6)
• TNGHT - "TNGHT" (LIGHT-DECENT 9)
• Gnaw Their Tongues - "Eschatological Scatology" (DECENT-STRONG 7)
• Purity Ring - "Shrines" (STRONG 5-LIGHT 6)
• Guardian Alien - "See the World Given to a One Love Entity" (DECENT-STRONG 6)
• Rick Ross - "God Forgives, I Don’t" (STRONG 2-LIGHT 3)
• Nachtmystium - "Silencing Machine" (DECENT-STRONG 8)
• Passion Pit - "Gossamer" (DECENT-STRONG 6)
• Om - "Advaitic Songs" (STRONG 5-LIGHT 6)
• Domo Genesis & The Alchemist - "No Idols" (STRONG 4-LIGHT 5)
• R. Stevie Moore - "Lo Fi Hi Fives... a Kind of Best Of" (STONG 6-LIGHT 7)
• Niki & The Dove - "Instinct" (LIGHT-DECENT 6)
• Ariel Pink’s Haunted Graffiti - "Mature Themes" (DECENT-STRONG 6)
• Parquet Courts - "Light Up Gold" (DECENT-STRONG 7)
• 2 Chainz - "Based on a T.R.U. Story" (LIGHT-DECENT 4)
• Xibalba - "Hasta La Muerte" (LIGHT-DECENT 8)
• JJ DOOM - "Key to the Kuffs" (LIGHT-DECENT 6)
• EPROM - "Metahuman" (NO SCORE)
• Jessie Ware - "Devotion" (DECENT-STRONG 4)
• Wild Nothing - "Nocturne" (LIGHT 8)
• Bloc Party - "Four" (DECENT-STRONG 7)
• Matthew Dear - "Beams" (STRONG 8)
• The Faceless - "Autotheism" (STRONG 5)
• Swans - "The Seer" (LIGHT-DECENT 8)
• A$AP Mob - "Lord$ Never Worry" (LIGHT-DECENT 3)
• Slaughterhouse - "welcome to: OUR HOUSE" (STRONG 3-LIGHT 3)
• Four Tet - "Pink" (DECENT-STRONG 7)
• Holy Other - "Held" (LIGHT-DECENT 6)
• Murder Construct - "Results" (LIGHT-DECENT 8)
• Animal Collective - "Centipede Hz" (LIGHT-DECENT 6)
• Jens Lekman - "I Know What Love Isn’t" (DECENT-STRONG 7)
• Mount Eerie - "Ocean Roar" (STRONG 5)
• Dan Deacon - "America" (STRONG 5)
• The xx - "Coexist" (STRONG 4-LIGHT 5)
• Krallice - "Years Past Matter" (STRONG 8-LIGHT 9)
• Ondatrópica - "Ondatrópica" (LIGHT-DECENT 9)
• Woods - "Bend Beyond" (DECENT-STRONG 7)
• Grizzly Bear - "Shields" (DECENT-STRONG 6)
• Dinosaur Jr. - "I Bet On Sky" (STRONG 7-LIGHT 8)
• David Byrne & St. Vincent - "Love This Giant" (STRONG 6-LIGHT 7)
• How to Dress Well - "Total Loss" (STRONG 6-LIGHT 7)
• Title Fight - "Floral Green" (STRONG 6-LIGHT 7)
• The Gaslamp Killer - "Breakthrough" (STRONG 7-LIGHT 8)
• Lupe Fiasco - "Food & Liquor II: The Great American Rap Album, Pt. 1" (STRONG 4-LIGHT 5)
• G.O.O.D. Music - "Kanye West Presents: Good Music - Cruel Summer" (NO SCORE)
• Dark Time Sunshine - "ANX" (DECENT-STRONG 7)
• Flying Lotus - "Until the Quiet Comes" (STRONG 7-LIGHT 8)
• Efterklang - "Piramida" (STRONG 4-LIGHT 5)
• Mumford & Sons - "Babel" (STRONG 6)
• Muse - "The 2nd Law" (LIGHT-DECENT 3)
• ​​alt-J - "An Awesome Wave" (LIGHT 8)
• Death Grips - "NO LOVE DEEP WEB" (LIGHT-DECENT 8)
• METZ - "METZ" (LIGHT-DECENT 6)
• MellowHype - "Numbers" (STRONG 2-LIGHT 3)
• Tame Impala - "Lonerism" (LIGHT-DECENT 8)
• The Mountain Goats - "Transcendental Youth" (DECENT-STRONG 7)
...2013:...2014:...2015:...2016:...2017:...2018:...2019:...2020:...2021:• The Roots - "Things Fall Apart" (CLASSIC)
• M.I.A. - "Arular" (CLASSIC)
• Nine Inch Nails - "The Downward Spiral" (CLASSIC)
• Portishead - "Dummy" (CLASSIC)
• Alice Coltrane - "Journey in Satchidananda" (CLASSIC)
• Gorillaz - "Plastic Beach" (DECENT-STRONG 9)
• Playboi Carti - "Whole Lotta Red" (DECENT-STRONG 5)
• Eminem - "Music to Be Murdered By: Side B" (DECENT-STRONG 3)
• Viagra Boys - "Welfare Jazz" (STRONG 7-LIGHT 8)
• ​shame - "Drunk Tank Pink" (DECENT-STRONG 6)
• DJ Sabrina The Teenage DJ - "Charmed" (LIGHT-DECENT 6)
...2022:• The Jimi Hendrix Experience - "Electric Ladyland" (CLASSIC)
• Elliott Smith - "Elliott Smith" (CLASSIC)
• Yellow Magic Orchestra - "Solid State Survivor" (CLASSIC)
• Stevie Wonder - "Songs in the Key of Life" (CLASSIC)
• Cocteau Twins - "Heaven or Las Vegas" (CLASSIC)
• Gunna - "DS4EVER" (NOT GOOD)
• The Weeknd - "Dawn FM" (STRONG 7-LIGHT 8)
• Nas - "Magic" (STRONG 6-LIGHT 7)
• Roddy Ricch - "LIVE LIFE FAST" (STRONG 3-LIGHT 4)
• Earl Sweatshirt - "SICK!" (DECENT-STRONG 6)
• FKA twigs - "CAPRISONGS" (DECENT-STRONG 8)
• Foxtails - "fawn" (LIGHT-DECENT 8)
• Cordae - "From a Birds Eye View" (LIGHT-DECENT 6)
​• tricot - "Joudeki" (DECENT-STRONG 7)
• Walker Hayes - "Country Stuff: The Album" (NOT BAD)
• Boris - "W" (DECENT-STRONG 4)
• Yard Act - "The Overload" (STRONG 6-LIGHT 7)
• AURORA - "The Gods We Can Touch" (LIGHT-DECENT 6)
• Amber Mark - "Three Dimensions Deep" (STRONG 6-LIGHT 7)
• Krallice - "Crystalline Exhaustion" (LIGHT-DECENT 8)
• Silvana Estrada - "Marchita" (LIGHT-DECENT 9)
• Ustalost - "Before the Glinting Spell Unvests" (DECENT-STRONG 7)
• Animal Collective - "Time Skiffs" (LIGHT-DECENT 7)
• Black Country, New Road - "Ants From Up There" (DECENT-STRONG 9)
• Mitski - "Laurel Hell" (STRONG 5-LIGHT 6)
• ​yeule - "Glitch Princess" (STRONG 6-LIGHT 7)
• Saba - "Few Good Things" (STRONG 6)
• Big Thief - "Dragon New Warm Mountain I Believe in You" (STRONG 8-LIGHT 9)
• $NOT - "Ethereal" (DECENT-STRONG 3)
• Spoon - "Lucifer On the Sofa" (DECENT 7)
• ​​alt-J - "The Dream" (STRONG 5-LIGHT 6)
• Yeat - "2 Alivë" (STRONG 3-LIGHT 4)
• Oliver Tree - "Cowboy Tears" (LIGHT-DECENT 3)
• Big K.R.I.T. - "Digital Roses Don't Die" (LIGHT-DECENT 4)
• Beach House - "Once Twice Melody" (LIGHT-DECENT 8)
• Black Dresses - "Forget Your Own Face" (STRONG 7-LIGHT 8)
• Zeal & Ardor - "Zeal & Ardor" (LIGHT-DECENT 4)
• Conway the Machine - "God Don't Make Mistakes" (STRONG 8-LIGHT 9)
• Avril Lavigne - "Love Sux" (STRONG 4-LIGHT 5)
• Kanye West - "Donda 2" (THERE ARE SOME COOL IDEAS HERE BUT I MOSTLY FEEL LIKE A VOYEUR AT THIS POINT LOOKING AT SOMETHING THAT IS VERY MUCH IN PROGRESS WHILE ALSO WATCHING ONE OF THE DARKEST TIMES OF SOMEBODY'S PERSONAL LIFE THAT I'M NOT REALLY SURE THAT I WANT ACCESS TO)
• EARTHGANG - "GHETTO GODS" (DECENT-STRONG 7)
• Chief Keef - "4NEM" (LIGHT-DECENT 7)
• Nilüfer Yanya - "PAINLESS" (LIGHT-DECENT 7)
• Vein.fm - "This World Is Going to Ruin You" (DECENT-STRONG 6)
• Charlotte Adigéry & Bolis Pupul - "Topical Dancer" (STRONG 8)
• The Cool Kids - "Before Shit Got Weird" (LIGHT-DECENT 7)
• Ghost - "Impera" (DECENT-STRONG 5)
• Rex Orange County - "WHO CARES?" (LIGHT-DECENT 7)
• Benny the Butcher - "Tana Talk 4" (STRONG 7-LIGHT 8)
• Alex Cameron - "Oxy Music" (LIGHT 6)
• Weezer - "SZNZ: Spring" (STRONG 5-LIGHT 6)
• Charli XCX - "CRASH" (LIGHT-DECENT 5)
• ROSALÍA - "MOTOMAMI" (DECENT-STRONG 7)
• Bladee & Ecco2k - "Crest" (STRONG 7-LIGHT 8)
• Machine Gun Kelly - "mainstream sellout" (LIGHT-DECENT 1)
• SOUL GLO - "Diaspora Problems" (DECENT-STRONG 9)
• Denzel Curry - "Melt My Eyez See Your Future" (DECENT-STRONG 8)
• Ibibio Sound Machine - "Electricity" (STRONG 7-LIGHT 8)
• Playboi Carti - "Whole Lotta Red" (DECENT-STRONG 5)
• Dreamville & J. Cole - "D-Day: A Gangsta Grillz Mixtape" (LIGHT 7)
• Red Hot Chili Peppers - "Unlimited Love" (STRONG 4-LIGHT 5)
• PUP - "THE UNRAVELING OF PUPTHEBAND" (DECENT-STRONG 6)
• Kilo Kish - "AMERICAN GURL" (STRONG 7-LIGHT 8)
• Kid Rock - "Bad Reputation" (NOT GOOD)
• Father John Misty - "Chloë and the Next 20th Century" (STRONG 4-LIGHT 5)
• Wet Leg - "Wet Leg" (LIGHT-DECENT 6)
• Yung Lean - "Stardust" (LIGHT-DECENT 5)
• Jack White - "Fear of the Dawn" (DECENT-STRONG 7)
• ​billy woods - "Aethiopes" (STRONG 8-LIGHT 9)
• Vince Staples - "RAMONA PARK BROKE MY HEART" (STRONG 6-LIGHT 7)
• Orville Peck - "Bronco" (LIGHT-DECENT 7)
• Daniel Rossen - "You Belong There" (LIGHT 8)
• Guerilla Toss - "Famously Alive" (DECENT-STRONG 6)
• Undeath - "It's Time​.​.​.​To Rise from the Grave" (DECENT-STRONG 7)
• Pusha T - "It's Almost Dry" (LIGHT-DECENT 8)
• King Gizzard & The Lizard Wizard - "Omnium Gatherum" (STRONG 6-LIGHT 7)
• Spiritualized - "Everything Was Beautiful" (DECENT-STRONG 8)
• Future - "I NEVER LIKED YOU" (STRONG 5-LIGHT 6)
• Haru Nemuri - "Shunka Ryougen" (LIGHT-DECENT 7)
• Toro y Moi - "MAHAL" (DECENT-STRONG 7)
• Rammstein - "Zeit" (STRONG 6)
• Arcade Fire - "WE" (LIGHT-DECENT 4)
• Jack Harlow - "Come Home The Kids Miss You" (LIGHT-DECENT 3)
• Otoboke Beaver - "SUPER CHAMPON" (DECENT-STRONG 8)
• Sharon Van Etten - "We've Been Going About This All Wrong" (STRONG 6-LIGHT 7)
• Kendrick Lamar - "Mr. Morale & The Big Steppers" (LIGHT 8)
• Black Star - "No Fear of Time" (LIGHT 5)
• The Smile - "A Light for Attracting Attention" (DECENT 7)
• Florence + the Machine - "Dance Fever" (DECENT-STRONG 7)
• Quelle Chris - "DEATHFAME" (DECENT-STRONG 7)
• Harry Styles - "Harry's House" (LIGHT-DECENT 6)
• Flume - "Palaces" (LIGHT-DECENT 6)
• Everything Everything - "Raw Data Feel" (STRONG 7-LIGHT 8)
• Ada Rook - "UGLY DEATH NO REDEMPTION ANGEL CURSE I LOVE YOU" (STRONG 7-LIGHT 8)
• Bad Bunny - "Un Verano Sin Ti" (DECENT-STRONG 6)
• Boldy Bad Man - "Killing Nothing" (LIGHT-DECENT 7)
• Gospel - "The Loser" (DECENT-STRONG 8)
• Angel Olsen - "Big Time" (LIGHT-DECENT 7)
• Post Malone - "Twelve Carat Toothache" (STRONG 3)
• KayCyy - "Get Used To It" (DECENT-STRONG 4)
• 070 Shake - "You Can't Kill Me" (DECENT-STRONG 6)
• Artificial Brain - "Artificial Brain" (LIGHT-DECENT 8)
• Destroyer - "LABYRINTHITIS" (STRONG 6-LIGHT 7)
• JER - "BOTHERED / UNBOTHERED" (LIGHT 8)
• Ethel Cain - "Preacher's Daughter" (STRONG 5-LIGHT 6)
• Drake - "Honestly, Nevermind" (NOT GOOD)
• Logic - "Vinyl Days" (LIGHT-DECENT 7)
• Perfume Genius - "Ugly Season" (DECENT-STRONG 7)
• Weezer - "SZNZ: Summer" (STRONG 4-LIGHT 5)
• Petrol Girls - "Baby" (LIGHT-DECENT 9)
• Lupe Fiasco - "DRILL MUSIC IN ZION" (DECENT-STRONG 8)
• Soccer Mommy - "Sometimes, Forever" (STRONG 7-LIGHT 8)
• Regina Spektor - "Home, before and after" (STRONG 6)
• Various Artists - "Minions: The Rise of Gru (Original Motion Picture Soundtrack)" (NOT GOOD)
• Krallice - "Psychagogue" (DECENT-STRONG 7)
• Leikeli47 - "Shape Up" (DECENT-STRONG 8)
• Zola Jesus - "Arkhon" (LIGHT-DECENT 7)
• Viagra Boys - "Cave World" (STRONG 9)
• Ken Carson - "X" (STRONG 0)
• Wormrot - "Hiss" (LIGHT 8)
• Westside Gunn - "Peace “Fly” God" (STRONG 5)
• Metric - "Formentera" (DECENT-STRONG 7)
• Lizzo - "Special" (STRONG 6-LIGHT 7)
• Steve Lacy - "Gemini Rights" (STRONG 6-LIGHT 7)
• ​black midi - "Hellfire" (DECENT-STRONG 9)
• Superorganism - "World Wide Pop" (STRONG 6)
• Jack White - "Entering Heaven Alive" (LIGHT-DECENT 5)
• Joey Bada$$ - "2000" (LIGHT-DECENT 7)
• Rico Nasty - "Las Ruinas" (STRONG 3-LIGHT 4)
• Chat Pile - "God's Country" (STRONG 8)
• Lil Uzi Vert - "RED & WHITE" (STRONG 6-LIGHT 7)
• Beyoncé - "RENAISSANCE" (DECENT-STRONG 8)
• DOMi & JD BECK - "NOT TiGHT" (STRONG 6-LIGHT 7)
• Meridian Brothers - "Meridian Brothers & El Grupo Renacimiento" (LIGHT-DECENT 8)
• Cheekface - "Too Much to Ask" (STRONG 7-LIGHT 8)
​• beabadoobee - "Beatopia" (STRONG 6-LIGHT 7)
• Megan Thee Stallion - "Traumazine" (LIGHT-DECENT 6)
• Destroy Lonely - "NO STYLIST" (LIGHT-DECENT 1)
• Panda Bear & Sonic Boom - "Reset" (LIGHT-DECENT 6)
• Danger Mouse & Black Thought - "Cheat Codes" (LIGHT-DECENT 8)
• Boris - "Heavy Rocks (2022)" (DECENT-STRONG 7)
• Hot Chip - "Freakout / Release" (STRONG 5-LIGHT 6)
• The Chats - "GET FUCKED" (DECENT-STRONG 7)
• Brent Faiyaz - "WASTELAND" (DECENT-STRONG 5)
• Hudson Mohawke - "Cry Sugar" (DECENT-STRONG 6)
• Imperial Triumphant - "Spirit of Ecstasy" (LIGHT-DECENT 7)
• DJ Khaled - "GOD DID" (STRONG 4-LIGHT 5)
• Muse - "Will of the People" (NOT GOOD)
• JID - "The Forever Story" (DECENT-STRONG 9)
• Roc Marciano & The Alchemist - "The Elephant Man's Bones" (LIGHT 6)
• Kenny Beats - "LOUIE" (DECENT-STRONG 8)
• Ghais Guevara - "There Will Be No Super-Slave" (DECENT-STRONG 7)
• Megadeth - "The Sick, the Dying... and the Dead!" (STRONG 3-LIGHT 4)
• NAV - "Demons Protected By Angels" (4 OUT OF STARS)
• Jockstrap - "I Love You Jennifer B" (LIGHT-DECENT 8)
• Yeat - "Lyfë" (STRONG 3-LIGHT 4)
• The Garden - "Horseshit On Route 66" (LIGHT-DECENT 7)
• Ari Lennox - "age/sex/location" (LIGHT 8)
• The Mars Volta - "The Mars Volta" (LIGHT-DECENT 6)
• Rina Sawayama - "Hold The Girl" (STRONG 5-LIGHT 6)
• Sudan Archives - "Natural Brown Prom Queen" (DECENT-STRONG 8)
• Preoccupations - "Arrangements" (STRONG 6)
• Weezer - "SZNZ: Autumn" (STRONG 3-LIGHT 4)
• Alex G - "God Save the Animals" (LIGHT-DECENT 7)
• ​death's dynamic shroud - "Darklife" (LIGHT-DECENT 8)
• LUCKI - "FLAWLESS LIKE ME" (DECENT-STRONG 1)
• The Comet Is Coming - "Hyper-Dimensional Expansion Beam" (STRONG 7-LIGHT 8)
• Björk - "Fossora" (LIGHT-DECENT 5)
• OFF! - "Free LSD" (LIGHT-DECENT 8)
• Kid Cudi - "Entergalactic" (STRONG 6)
• Yeah Yeah Yeahs - "Cool It Down" (LIGHT-DECENT 5)
• Bladee - "Spiderr" (DECENT-STRONG 7)
• Freddie Gibbs - "$oul $old $eparately" (STRONG 7-LIGHT 8)
​• billy woods - "Church" (STRONG 5-LIGHT 6)
• Alvvays - "Blue Rev" (LIGHT-DECENT 7)
• Jean Dawson - "CHAOS NOW*" (DECENT-STRONG 7)
• Slipknot - "The End, So Far" (DECENT-STRONG 4)
• M.I.A. - "MATA" (LIGHT 5)
• Autopsy - "Morbidity Triumphant" (LIGHT-DECENT 8)
• Red Hot Chili Peppers - "Return of the Dream Canteen" (LIGHT-DECENT 6)
• Lil Baby - "It's Only Me" (LIGHT-DECENT 4)
• The 1975 - "Being Funny in a Foreign Language" (LIGHT 7)
• Arctic Monkeys - "The Car" (STRONG 3-LIGHT 4)
• Taylor Swift - "Midnights" (STRONG 4-LIGHT 5)
• Carly Rae Jepsen - "The Loneliest Time" (STRONG 5-LIGHT 6)
• BabyTron - "Bin Reaper 3: Old Testament" (STRONG 7-LIGHT 8)
• Smino - "Luv 4 Rent" (DECENT 8)
• Westside Gunn - "10" (STRONG 7)
• Natalia Lafourcade - "De todas las flores" (DECENT-STRONG 9)
• Joji - "SMITHEREENS" (STRONG 4-LIGHT 5)
• Drake & 21 Savage - "Her Loss" (DECENT-STRONG 6)
• Open Mike Eagle - "a tape called component system with the auto reverse" (STRONG 7)
• Backxwash - "HIS HAPPINESS SHALL COME FIRST EVEN THOUGH WE ARE SUFFERING" (STRONG 7-LIGHT 8)
• Nas - "King's Disease III" (DECENT 8)
• MGMT - "11•11•11" (STRONG 4-LIGHT 5)
• Quadeca - "I Didn't Mean To Haunt You" (STRONG 7)
• BROCKHAMPTON - "The Family" (STRONG 4)
• BROCKHAMPTON - "TM" (STRONG 3)
• Weyes Blood - "And in the Darkness, Hearts Aglow" (LIGHT-DECENT 7)
• Ashenspire - "Hostile Architecture" (LIGHT-DECENT 9)
• Richard Dawson - "The Ruby Cord" (STRONG 7-LIGHT 8)
• Polyphia - "Remember That You Will Die" (LIGHT-DECENT 5)
• Stormzy - "This Is What I Mean" (STRONG 5-LIGHT 6)
• Fred again.. - "Actual Life 3 (January 1 - September 9 2022)" (LIGHT-DECENT 6)
• Show Me the Body - "Trouble the Water" (STRONG 5)
• Gilla Band - "Most Normal" (LIGHT 5)
• Metro Boomin - "HEROES & VILLAINS" (LIGHT-DECENT 7)
• Adeem the Artist - "White Trash Revelry" (STRONG 8)
• ​brakence - "hypochondriac" (LIGHT-DECENT 5)
• Thaiboy Digital - "Back 2 Life" (LIGHT-DECENT 6)
• SZA - "SOS" (LIGHT-DECENT 8)
• Little Simz - "NO THANK YOU" (STRONG 7-LIGHT 8)
• Ka - "Languish Arts" (LIGHT-DECENT 7)
• Ka - "Woeful Studies" (LIGHT-DECENT 7)2023:• Bone Thugs-N-Harmony - "E. 1999 Eternal" (CLASSIC)
• Dolly Parton - "Jolene" (CLASSIC)
• The Smiths - "The Queen is Dead" (CLASSIC)
• Sade - "Diamond Life" (CLASSIC)
• The Avalanches - "Since I Left You" (CLASSIC)
• Mac Miller - "Swimming" (STRONG 7-LIGHT 8)
• Weezer - "SZNZ: Winter" (LIGHT-DECENT 7)
• Ab-Soul - "Herbert" (STRONG 6)
• Sematary - "BUTCHER HOUSE" (STRONG 6-LIGHT 7)
• Ice Spice - "Like..?" (STRONG 5-LIGHT 6)
• Måneskin - "RUSH!" (STRONG 2)
• Mac DeMarco - "Five Easy Hot Dogs" (STRONG 3)
• Trippie Redd - "MANSION MUSIK" (LIGHT-DECENT 5)
• Lil Yachty - "Let's Start Here." (LIGHT-DECENT 7)
• Horse Lords - "Comradely Objects" (DECENT-STRONG 7)
• JIMMY - "*GHETTOLAND" (DECENT-STRONG 6)
• Parannoul - "After the Magic" (DECENT 8)
• Sam Smith - "Gloria" (STRONG 5-LIGHT 6)
• Young Fathers - "Heavy Heavy" (STRONG 7-LIGHT 8)
• HARDY - "the mockingbird & THE CROW" (NOT GOOD)
• Paramore - "This Is Why" (DECENT 8)
• Kelela - "Raven" (STRONG 6)
• Flume - "Things Don’t Always Go The Way You Plan" (LIGHT 5)
• Caroline Polachek - "Desire, I Want to Turn Into You" (STRONG 8)
• Tony Molina - "In the Fade" (LIGHT 8)
• Skrillex - "Don't Get Too Close" (LIGHT-DECENT 3)
• Skrillex - "Quest For Fire" (LIGHT-DECENT 7)
• Yo La Tengo - "This Stupid World" (LIGHT-DECENT 5)
• Liv.e - "Girl In The Half Pearl" (STRONG 5-LIGHT 6)
• Yeat - "AftërLyfe" (STRONG 6-LIGHT 7)
• Gorillaz - "Cracker Island" (LIGHT-DECENT 6)
• Model/Actriz - "Dogsbody" (DECENT-STRONG 8)
• Logic - "College Park" (LIGHT 5)
• U.S. Girls - "Bless This Mess" (STRONG 5-LIGHT 6)
• ​slowthai - "UGLY" (STRONG 8)
• Don Toliver - "Love Sick" (LIGHT-DECENT 5)
​• shame - "Food for Worms" (DECENT 7)
• Kali Uchis - "Red Moon In Venus" (LIGHT 7)
• Xiu Xiu - "Ignore Grief" (LIGHT-DECENT 6)
• Macklemore - "BEN" (LIGHT-DECENT 2)
• Fever Ray - "Radical Romantics" (STRONG 6-LIGHT 7)
• Miley Cyrus - "Endless Summer Vacation" (DECENT-STRONG 4)
• Algiers - "Shook" (DECENT-STRONG 6)
• 100 gecs - "10,000 gecs" (LIGHT 8)
• Yves Tumor - "Praise a Lord Who Chews but Which Does Not Consume; (Or Simply, Hot Between Worlds)" (STRONG 6)
• Lil Pump - "Lil Pump 2" (NOT GOOD)
• M83 - "Fantasy" (LIGHT 5)
• Black Country, New Road - "Live at Bush Hall" (STRONG 7)
• Fall Out Boy - "So Much (For) Stardust" (DECENT-STRONG 3)
• JPEGMAFIA & Danny Brown - "SCARING THE HOES" (LIGHT 9)
• Lana Del Rey - "Did you know that there’s a tunnel under Ocean Blvd" (LIGHT-DECENT 9)
• Melanie Martinez - "PORTALS" (NO SCORE)
• Larry June & The Alchemist - "The Great Escape" (STRONG 3-LIGHT 4)
• Navy Blue - "Ways of Knowing" (STRONG 7-LIGHT 8)
​• boygenius - "the record" (STRONG 7)
• The HIRS Collective - "We’re Still Here" (DECENT 8)
• ​tricot - "Fudeki" (LIGHT 7)
• Rae Sremmurd - "Sremm 4 Life" (LIGHT 2)
• Liturgy - "93696" (STRONG 8-LIGHT 9)
• Tim Hecker - "No Highs" (LIGHT 7)
• Daniel Caesar - "NEVER ENOUGH" (LIGHT 6)
• Metallica - "72 Seasons" (STRONG 4-LIGHT 5)
• Kara Jackson - "Why Does the Earth Give Us People to Love?" (STRONG 8-LIGHT 9)
• Frost Children - SPEED RUN (DECENT-STRONG 7)
• NF - "HOPE" (NOT GOOD)
• Depeche Mode - "Memento Mori" (LIGHT-DECENT 7)
• Mac DeMarco - "One Wayne G" (GARBAGE BUT FUN TO MAKE)
• HMLTD - "The Worm" (DECENT-STRONG 4)
• Portrayal of Guilt - "Devil Music" (LIGHT-DECENT 7)
• Jack Harlow - "Jackman." (LIGHT 5)
• Jessie Ware - "That! Feels Good!" (DECENT 8)
• The National - "First Two Pages of Frankenstein" (LIGHT 2)
• Indigo De Souza - "All of This Will End" (LIGHT 6)
• Destroy Lonely - "If Looks Could Kill" (STRONG 1-LIGHT 2)
• Ed Sheeran - "-" (LIGHT 5)
​• billy woods & ​kenny segal - "Maps" (DECENT 8)
• Conway the Machine - "WON'T HE DO IT" (STRONG 5)
• The Smashing Pumpkins - "ATUM: A Rock Opera in Three Acts" (LIGHT-DECENT 3)
• YoungBoy Never Broke Again - "Richest Opp" (LIGHT 5)
• El Michels Affair & Black Thought - "Glorious Game" (DECENT 7)
• The Lemon Twigs - "Everything Harmony" (STRONG 8)
• Fire-Toolz - "I am upset because I see something that is not there." (DECENT-STRONG 6)
• KAYTRAMINÉ - "KAYTRAMINÉ" (STRONG 5-LIGHT 6)
• Lonnie Holley - "Oh Me Oh My" (LIGHT-DECENT 9)
• Sleep Token - "Take Me Back To Eden" (LIGHT 2)
• Kesha - "Gag Order" (LIGHT-DECENT 7)
• Jeromes Dream - "The Gray in Between" (STRONG 7-LIGHT 8)
• Lil Durk - "Almost Healed" (STRONG 4-LIGHT 5)
• AJJ - "Disposable Everything" (STRONG 6-LIGHT 7)
• Colin Stetson - "When We Were That What Wept for the Sea" (STRONG 8)
• Snow Strippers - "April Mixtape 3" (LIGHT 8)
• Avenged Sevenfold - "Life Is But a Dream…" (NOT GOOD)
• Foo Fighters - "But Here We Are" (LIGHT 8)
• Thantifaxath - "Hive Mind Narcosis" (LIGHT 8)
• Protomartyr - "Formal Growth In The Desert" (STRONG 6-LIGHT 7)
• Janelle Monáe - "The Age of Pleasure" (LIGHT-DECENT 6)
• King Krule - "Space Heavy" (STRONG 8)
• Squid - "O Monolith" (STRONG 8-LIGHT 9)
• McKinley Dixon - "Beloved! Paradise! Jazz!?" (LIGHT 9)
​• feeble little horse - "Girl with Fish" (DECENT-STRONG 8)
• Gunna - "a Gift & a Curse" (DECENT-STRONG 1)
• King Gizzard & The Lizard Wizard - "PetroDragonic Apocalypse; or Dawn of Eternal Night: An Annihilation of Planet Earth and the Beginning of Merciless Damnation" (STRONG 8-LIGHT 9)
• Queens of the Stone Age - "In Times New Roman..." (DECENT-STRONG 6)
• Killer Mike - "MICHAEL" (LIGHT-DECENT 6)
• Sigur Rós - "ÁTTA" (LIGHT 4)
• Young Thug - "BUSINESS IS BUSINESS" (STRONG 4-LIGHT 5)
• Swans - "The Beggar" (DECENT-STRONG 7)
• Geese - "3D Country" (LIGHT-DECENT 8)
• Lil Uzi Vert - "Pink Tape" (DECENT-STRONG 5)
• Joanna Sternberg - "I've Got Me" (LIGHT-DECENT 8)
• ​grouptherapy. - "I Was Mature For My Age, But I Was Still a Child" (LIGHT-DECENT 8)
• LUCKI - "s*x m*ney dr*gs" (LIGHT 2)
• Dominic Fike - "Sunburn" (LIGHT-DECENT 4)
• PJ Harvey - "I Inside the Old Year Dying" (LIGHT-DECENT 7)
• Tainy - "DATA" (LIGHT-DECENT 7)
• ANOHNI - "My Back Was A Bridge For You To Cross" (STRONG 8-LIGHT 9)
• Disclosure - "Alchemy" (LIGHT-DECENT 5)
• J Hus - "Beautiful and Brutal Yard" (LIGHT-DECENT 5)
• WITCH - "Zango" (STRONG 8)
• Key Glock - "Glockoma 2" (STRONG 7-LIGHT 8)
• Jason Isbell and the 400 Unit - "Weathervanes" (LIGHT 7)
• Various Artists - "Barbie The Album" (DECENT 6)
• Greta Van Fleet - "Starcatcher" (DECENT-STRONG 3)
• Paris Texas - "MID AIR" (LIGHT 3)
• Nas - "Magic 2" (LIGHT-DECENT 6)
• Blur - "The Ballad of Darren" (STRONG 6-LIGHT 7)
• Travis Scott - "UTOPIA" (DECENT-STRONG 7)
• Post Malone - "AUSTIN" (DECENT-STRONG 3)
• Carly Rae Jepsen - "The Loveliest Time" (LIGHT-DECENT 6)
• George Clanton - "Ooh Rap I Ya" (LIGHT 8)
• Snooper - "Super Sn​õ​õ​per" (DECENT 8)
• Amaarae - "Fountain Baby" (STRONG 8-LIGHT 9)
• Noname - "Sundial" (STRONG 5-LIGHT 6)
• Trippie Redd - "A Love Letter To You 5" (STRONG 4)1Embed