15 ContributorsSeptember 2023 Singles Release Calendar Lyrics9/1
AK - "Restless"
Ali Gatie - "Afterlife"
Baby Tate - "Jersey"
Bears in Trees - "Cassiopeia"
Bella Dose - "FFIL"
Britt Nicole - "Weekend Magic"
Carter Faith - "Carolina Burns"
CelNoLackin - "NoLackin Flow"
CHASE B - "Street Sweeper" ft. Swae Lee
Danielle Bradbery - "The Day That I'm Over You"
Davido, Sean Paul & Ding Dong - "UNAVAILABLE (Sean Paul & DING DONG Remix)" ft. Musa Keys
Dee Gatti - "Either Way"
Denise Van Outen & Duncan James - "That's What Friends Are For"
Dj Norie & Sean Paul - "Cheers 2 U"
Doja Cat - "Demons"
Draft Day - "LUV & DRUGS"
Eric Bellinger - "Find Someone"
Finessе2Tymes - "Can't Go To Jail"
Global Dan - "89 Keys"
Hoodie Allеn & Jake Miller - "Outta Reach"
jenny nuo - "accidental win"
JID & Lil Yachty - "Van Gogh"
JID & Lil Yachty - "Half Doin' Dope" ft. BabyTron
Kanii - "​marry me"
Karen Harding - "Wrong Places"
Kat DeLuna - "Hottie With a Body"
Kate Stewart - "Name Out Your Mouth"
Kenya Grace - "Strangers"
kkbutterfly27xx - "obsessed with the boy"
Lauren Mayberry - "Are You Awake?"
Lil Pump - "6 Rings"
Lil Wayne - "KAT Food"
Lola Indigo & DELLAFUENTE - "MALA SUERTE"
Lost Frequencies & Tom Gregory - "Dive"
Måneskin - "HONEY! (Are u coming?)"
Maria Mena - "Till the Water Runs Clear"
Mayer Hawthorne - "For All Time"
MIKA - "C'est la Vie"
mike. - "we die once"
Mr Eazi - "Advice"
Nicki Minaj - "Last Time I Saw You"
Odeal - "All That It Takes"
otuka - "stuckk on you"
Paris Paloma - "as good a reason"
Queen Naija & YoungBoy Never Broke Again - "No Fake Love"
R3HAB, Marnik & Vinai - "Rock My Body (Marnik & VINAI Remix)" ft. INNA & SASH!
Real Boston Richey - "Black Truck"
Rod Wave - "Come See Me"
SAFE - "Rent Free"
Sam Fischer - "Afterglow"
Sarah Proctor & Jolé - "I Don't Know What Love Will Do"
Surf & ITSOKTOCRY - "Kardashian"
Teddy & Brennan Savage - "Peppermint"
​teo glacier & ​thuy - "​close with desires"
Timbaland - "Keep Going Up" ft. Nelly Furtado & Justin Timberlake
TisaKorean - "​Rando"
will.i.am, David Guetta & Britney Spears - "MIND YOUR BUSINESS (David Guetta Remix)"
Wiz Khalifa & Chevy Woods - "​Oakland Originals"
Yella Beezy - "​Ha Ha"
YNP Maine - "Aventador"
9/3
Phidel - "Outfool You" ft. Nenorama

9/5
Femdot. - "Missy Elliott"
FEYZAL - "Guarded"
Jay Critch - "Homesick"
9/6
Arianna Reid - "Soulmate"
Chris Patrick - "Lock It Up"
Eli Fross - "Bonnie & Clyde"
GloRilla, Gloss Up & Slimeroni - "Wrong One" ft. Aleza, K Carbon & Tay Keith
KATO2X - "Snatch WHO Chain"
Nasty C & Benny the Butcher - "Prosper In Peace"
The Rolling Stones - "Angry"
Vince Clarke - "The Lamentations of Jeremiah"
9/7
Baby Bugs - "Diseased"
Clavish & Aitch - "Tip Toes"
ELENA ROSE - "Linda Natural"
Kian Kova - "Tu Fotito"
Leigh-Anne - "My Love" ft. Ayra Starr
Mac Critter - "Run On It"
Scotty ATL, CeeLo Green & K CAMP - "Major"
Sofía Reyes - "HOY ME PORTO MAL"
Stunna Girl & Mozzy - "Wake Dis Shit Up"
9/8
1017 ALYX 9SM & Hardrock - "Black Truck Schemin"
22nd Jim & Babyface Ray - "Money"
310babii, Blueface & Tyga - "Soak City" ft. Mustard, OhGeesy & BlueBucksClan
Abraham Mateo & Sebastián Yatra - "XQ Sigues Pasando?"
Alex Warren - "How Could You (Be OK)"
Baby Jungle - "No Dissin"
BJ the Chicago Kid & Coco Jones - "Spend The Night"
BlakeIANA - "BING BONG (Remix)" ft. Sexyy Red
Bryson Tiller - "Down Like That"
Busta Rhymes - "LUXURY LIFE" ft. Coi Leray
Cardi B - "Bongos" ft. Megan Thee Stallion
CG5 - "BRO"
Chris Stapleton - "Think I'm In Love With You"
Dagny - "Ray-Bans"
Daniel Allan, BKAYE & Kevin George - "Go Ahead"
Ela Taubert - "¿Y Si Eras Tú?"
Flo Milli - "Chocolate Rain"
GANG51E JUNE - "Crushed Down"
Great Good Fine OK - "Midnight Rain"
iann dior - "You Don't Even"
Jamal (Blaq) - "BONITA" ft. AJ Tracey
Jon Vinyl - "Wasted"
Joyner Lucas - "Seventeen"
Katelyn Tarver - "Ignorance Is Bliss"
Kelly Clarkson - "roses"
Kenyon Dixon - "'98 Vibes (Do You Right)" ft. Tiffany Gouché
Killer Mike - "MAYNARD VIGNETTE" ft. T.I., JID & Jacquees
KYLE - "Suddenly"
Lil 50 & G Herbo - "All Type"
Lil Pump - "Glow In The Dark"
Manu Crooks - "Lately"
Marshmello & Dove Cameron - "Other Boys"
mike. - "smiley water"
MOTHICA - "SIRENS" ft. Sophie Powers
NLE Choppa - "College Girls"
OsamaSon - "Trenches"
Peezy, Money Man & Larry June - "Fashion Week"
Perto - "jester"
Quin NFN & Sauce Walka - "Boss Blues"
RealestK - "Stranger"
Rotimi - "Bestie"
Surfaces - "Cloud"
Stunna 4 Vegas & Skilla Baby - "Made Men"
Tee Grizzley - "IDGAF" ft. Chris Brown & Mariah the Scientist
Thouxanbanfauni - "High Roller"
Trackdilla - "Nrg" ft. Roy Woods
Ufo361 - "COBAIN"
​unodavid - "Through the Night"
VEDO - "Split"
Xanman & Bigg OC - "Coke Pills" ft. Sauce Walka
Young Nudy - "Peaches & Eggplants (Remix)" ft. Latto & Sexyy Red
YSN Fab - "Love Scars"
9/9
Maeve De Voe - "Last Surprise"
Soulja Boy - "Sold Out Concerts"
9/11
Miles Chancellor & 2SEATER - "Knight Rider II"
Toby Romeo & Declan J Donovan - "Alive"
9/12
Brezden - "BRRR B" ft. Gucci Mane
Dan García - "Tirando Flow Sesh #12" ft. John C & ND Kobi'
Lil Nuu - "Day I Got Shot"
Phidel - "Never Let You Go" ft. OlinaW

9/13
Ayra Starr - "Rhythm & Blues"
Bazzi - "Doing Time"
Daisy the Great - "Rill Rill"
Dende & Xavier Omär - "Flowers (Remix)"
Eli Sostre - "Broken"
Majid Jordan - "Waiting For You" ft. Naomi Sharon
Midas The Jagaban - "Louis Vitty" ft. Tayc
Sia - "Gimme Love"
Soulja Boy - "150 Bricks"
9/14
Al-Doms - "Til My Heart Stops" ft. Alessandra Salinas
Al-Doms - "Til My Heart Stops - A Colors Show" ft. Alessandra Salinas
Becky G - "QUERIDO ABUELO"
J Balvin, Usher & DJ Khaled - "Dientes"
La Rhonza - "All Inclusive"
Lil Darius - "Meant 4 You"
MILCK & Natasha Bedingfield - "Your Child My Child"
Rod Wave - "Checkmate"
The Shindellas - "Think of Me"
TSHA, Ellie Goulding & Gregory Porter - "Somebody"
9/15
Aandrq - "Demur"
AK - "Affiliated"
Alex Gaudino, Dopamine & MazZz - "Saturday"
Ali Gatie - "Wandering Eyes"
All Time Low - "Fake As Hell" ft. Avril Lavigne
Amaal - "Red Light"
Ambré - "stronger than pride"
Andy Grammer & Pentatonix - "Expensive"
Bella Poarch - "Crush" ft. Lauv
BEO Lil Kenny - "Too Much" ft. Gucci Mane
Big Boogie - "Ova Wit"
Caity Baser - "Disco Shoes"
Calvin Harris & Sam Smith - "Desire (Hannah Laing Remix)"
charlieonnafriday - "Undefeated"
Doja Cat - "Balut"
Drake - "Slime You Out" ft. SZA
EKKSTACY - "problems" ft. Trippie Redd
guardin - "distant memories"
JACOTÉNE - "I Need Therapy 2.4 (alt_demo)"
Judith Hill - "Runaway Train"
Kaash Paige - "Skitzo"
Keke Palmer - "Assets"
Kevin Gates - "Walmart"
Keltro - "Truly Madly Deeply" ft. Caroline Kole
LOEK & Conor Maynard - "Mamma Told Me"
LOONY - "A Good Night"
Maren Morris - "Get The Hell Out Of Here"
Maren Morris - "The Tree"
María Isabel - "I Drove U Crazy"
Muni Long - "Made For Me"
Neoni - "PITY PARTY" ft. Ellise
Nick Lachey - "Temporary" ft. Kara DioGuardi
Noah Kahan & Lizzy McAlpine - "Call Your Mom"
Noodah05 - "Making the Money"
Offset - "FAN"
OneRepublic - "Counting Stars (2023 Version)"
Picture This - "Leftover Love"
Pitbull - "Freak 54 (Freak Out)" ft. Nile Rogers
Roxette - "Listen To Your Heart (Alle Farben Remix)"
Sango & Masego - "Masego's Interlude"
Shenseea - "Waistline"
$NOT - "CRUEL WORLD"
SOUNDRAW - "Doin Me" ft. Fivio Foreign
SZA - "Snooze (Acoustic)" ft. Justin Bieber
Tash - "From You"
Tate McRae - "greedy"
TOMORROW X TOGETHER & Anitta - "Back for More"
Tyler Cole - "Wish You Would"
Yot Club - "Safe House" ft. Jordana
Yungeen Ace - "Roadkill"
Zara Larsson & David Guetta - "On My Love"
9/18
Dizzee Rascal - "Sugar and Spice" ft. iLL BLU

9/19
BiC Fizzle - "Clarity"
Doechii - "Pacer"
Dokken - "Gypsy"
poptropicaslutz! - "True Colors"
9/20
BigWalkDog - "Freestyle"
Bleachers - "Modern Girl"
Chris Patrick - "Slide On Me"
Emeli Sandé - "How Were We To Know"
Jay Fizzle - "Dickie Set"
Jewel - "Hands (Studio Outtake)"
The Vaccines - "Heartbreak Kid"
Troye Sivan - "Got Me Started"
9/21
Holly Humberstone - "Into Your Room"
Jacob Collier - "Little Blue" ft. Brandi Carlile
Kane Brown - "I Can Feel It"
Mac Critter - "Spinnin Til The End"
NSG - "NELLA ROSE"
Popcaan - "Rite A Foot"
9/22
070 Shake - "Black Dress"
21 Lil Harold - "GTA"
Aandrq - "Qualm"
Alex Sampson - "Til The World Gets Sick of Us"
Alok, The Chainsmokers & Mae Stephens - "Jungle"
Arian Cruz - "Flyin' To My Heart"
Banx & Ranx - "After Party (Just Dance)" ft. Zach Zoya
Belhassen Kadim - "Problématique"
BoyWithUke - "Migraine"
Breez Kennedy - "Like My Ex"
Byron Messia - "Mad Dawgs"
​carolesdaughter - "Good In Bed"
Calboy - "Gang Time" ft. Skilla Baby
Carvena - "Sleep In"
CG5 & DHeusta - "Coming Back For More"
Cody Johnson - "Watching My Old Flame"
Cody Johnson - "Work Boots"
Daya - "Downtown"
Derivakat - "Smile"
Destiny Rogers - "Save My Love"
Doe Boy & Skilla Baby - "Smack Sh*t"
ericdoa - "kickstand"
Finesse2Tymes - "Warfare"
James Blunt – "All The Love That I Ever Needed"
J.I the Prince of N.Y - "Turn Me Up"
Jean Dawson & SZA - "NO SZNS"
Jesse Boykins III - "Go With the Feeling"
JKING & Dinah Jane – "Falling In Love"
Joony - "NEED IT"
Lady A - "Love You Back"
Lil Migo - "Detox"
Lola Brooke - "You" ft. Bryson Tiller
LSR/CITY, Gareth Emery & Annabel - "Like a Prayer"
Luke Grimes - "Burn"
Maiya The Don - "Body"
Now United - "Bop Bop"
OneRepublic, Assassin's Creed & Mishaal Tamer - "Mirage (for Assassin's Creed Mirage)"
RealestK - "Better"
Sarina - "Damage"
Scene Queen - "Pink Push-Up Bra"
Steve Aoki & Danna Paola - "Paranoia"
Taska Black – "Summer Nights" ft. emma løv & Loote
Tom Odell - "Black Friday"
Vinai & Alexandra Stan - "Believe"
Wolftyla - "Love Bites"
Yoza - "Eventually"
Sematary - "King Of The Graveyard"
9/23
CG5 - "Live Love Lie"
9/25
Bad Bunny - "UN PREVIEW"
Empress Of - "Kiss Me" ft. Rina Sawayama
Soulja Boy - "BBL"
Soulja Boy - "Play With You"
9/26
Chase Atlantic - "MAMACITA"
iamjakehill - "F.T.B"
SadBoi - "Sister Wives"
9/27
Erykah Officer - "GLS"
Jay Fizzle - "FREE STR8DROPP"
Monaleo - "Crying On Your Birthday"
North Ave Jax & ​jetsonmade - "D.I.Y.A. (Die In Your Arms) [Acoustic]"
R3 Da Chilliman - "Only Problem" ft. 03 Greedo
Raedio & Sexyy Red - "No Panties"
Sum 41 - "Landmines"
Tony K - "Right Now"
Tyga, YG & Lil Wayne - "Brand New"
Windser - "TV"
9/28
Daft Punk - "Within (Drumless Edition)"
KATO2X - "2 Talk"
Marzz - "Switching Sides" ft. Dee Gotti
No Guidnce - "Spicy"
The Plug & Stefflon Don - "Run Through" ft. Swae Lee
The Rolling Stones & Lady Gaga - "Sweet Sounds of Heaven"
Yailin la Mas Viral, 6ix9ine & Ben El - "FEEFAFO"
9/29
6LACK - "Mean It"
Abigail Osborn - "In Case of Emergency"
AK - "Let The Birds Sing"
Ali Gatie - "Strangers Again"
Alle Farben, James Carter & VARGEN - "Wanna Dance"
Ally Brooke - "Gone to Bed"
Aristoteles & Kenzo Alvares - "Telescope"
Augustine - "Woman"
Brittney Spencer - "Bigger Than The Song"
Calvin Harris & Sam Smith - "Desire (MEDUZA Remix)"
Campbell & Alcemist - "Would You (go to bed with me?)" ft. Caity Baser
Catie Turner - "Empty"
Clever - "Stick By My Side 2" ft. NLE Choppa
DaBaby - "TRICKIN'"
Dahi & Elmiene - "Shame"
Dallas Smith - "CRZY"
Dallas Smith - "Fixer Upper"
David Guetta & Bebe Rexha - "I'm Good (Blue) [2023 Version]" ft. LUDMILLA & LIT killah
Deepend, Andrew Allen & LAST CALL - "Gonna Love"
Enrique Iglesias & María Becerra - "ASI ES LA VIDA"
Europe - "Hold Your Head Up"
Finesse2Tymes - "Can't Go To Jail (Remix)" ft. Sett & YTB Fatt
Flyana Boss - "Big One"
Griff - "Vertigo (Alternative Version)"
Hannah Grae - "It Could've Been You"
Iggy Azalea & Ivorian Doll - "Money Come (Remix)" ft. Big Boss Vette
Ivory Scott & Queen Naija - "My Mind"
Jack Kays - "Feel Like Me"
Jade Novah. "What's Your Sign?"
Jake Miller - "Sunflower"
Jax Jones, D.O.D, Ina Wroldsen - "Won't Forget You"
Jonah Kagen – "Pollution"
Joy Anonymous - "JOY (I Did You Wrong)"
Jung Kook (정국) - "3D" ft. Jack Harlow
Keke Palmer - "Serious"
‎kurtains - "reefer" ft. Zootzie
Latto - "ISSA PARTY" ft. BabyDrill
Lil Nuu - "YOP"
Lil Tony Official - "Canoozled"
Lil Uzi Vert - "NFL"
Lyrical Lemonade, Lil Durk & Kid Cudi - "Guitar In My Room"
L'Rain - "r(EMOTE)"
Maxo Kream - "Whatchamacallit" ft. Luh Tyler
Mayer Hawthorne - "Without You"
Natalie Jane - "Do or Die (Acoustic)"
NEIKED - "You're Hired" ft. Ayra Starr
Ne-Yo - "Link Up"
Nightshift - "Empty House"
*NSYNC & Justin Timberlake - "Better Place"
Peezy & BabyTron - "Psilocybin"
PinkPantheress - "Mosquito"
PGS Spence & Armani White - "Buckle Up (Remix)
Ramriddlz - "Alexa"
Rick Ross & Meek Mill - "SHAQ & KOBE"
Ryan Trey - "30 Floors Up"
Samara Joy – "Have Yourself A Merry Little Christmas"
Samaria - "​wish you hell"
Skilla Baby - "Bae"
Surf Mesa - "Run" ft. Griff Clawson
Thomas Rhett & Morgan Wallen - "Mamaw's House (feat. Morgan Wallen)"
U2 - "Atomic City"
Zacari - "Reverse" ft James Fauntleroy

9/30
CG5 - "NAPOLEON"Embed