8 ContributorsOctober 2021 Singles Release Calendar Lyrics10/1
Agnes - "Here Comes the Night"
Amaria BB - "Fundz" ft. Skillibeng
Arizona Zervas - "C U L8R"
Betta Lemme - "I'm Good"
Bino Rideaux & Roddy Ricch - "LEMME FIND OUT"
BKTHERULA - "PLACEMENT" ft. Matt Ox
Bullet for My Valentine - "Rainbow Veins"
Calum Scott - "Rise"
Capella Grey & Popcaan - "GYALIS (Remix)" ft. Chris Brown
CHASE B, Babyface Ray, Zona Man & GT - "365"
Cheat Codes, Grey & Tyson Ritter - "Hurricane"
Chelsea Cutler - "Devil on My Shoulder"
City Morgue - "WHAT'S MY NAME"
Danny Beau - "21&WILD"
Da YoungFellaz - "NBA JAM" ft. Smoke DZA
Derrick Milano - "die4it"
DOM KENNEDY - "Rollin Papers"
DUST IN MIND - "Synapses"
​elijah​ woods - "Someone New"
Elujay & ​serpentwithfeet - "Luvaroq"
Euroz - "Flawless"
Gracie Abrams - "Feels Like"
Hiddxn - "Later" ft. EDDISON
Jessie Murph - "Sobriety"
JON VINYL - "Always"
Josh Dean - "Impatient (Remix)" ft. Deante' Hitchcock
Katy B - "Open Wound" ft. Jaz Karis
KayCyy - "Stay Up" ft. Lancey Foux
Kent Jones - "Bout That" ft. Rick Ross
Key Glock - "Ambition for Cash"
Like Saturn - "descending"
Little Simz - "Venom (Remix)"
Louis the Child & Livingston - "Hole in My Heart"
Nadia Rose - "WOAH"
New Saviors - "End Me" ft. Harrison Seanor
Nija - "Finesse"
Oh Wonder - "Don't Let the Neighbourhood Hear"
Oliver Tree - Life Goes On (Clean Bandit Remix)
Omarion - "Ex" ft. Bow Wow & Soulja Boy
Parisalexa - "Vroom"
PJ Morton - "Please Don't Walk Away"
Problem & Snoop Dogg - "DIM MY LIGHT"
Red Cafe & Benny The Butcher - "Drug Money"
Rezz & fknsyd - "Let Me In"
RINI - "Need It"
Samm Henshaw - "Chicken Wings"
Savage Ga$p & KAMAARA - "​a mosh pit love story"
SLUMBERJACK - "Better Off" ft. Lucy Lucy
Steve Aoki - "Aurora"
T-Pain - "I Like Dat" ft. BIA & Kehlani
The Alchemist - "Miracle Baby" ft. MAVI
The Neighbourhood - "Fallen Star"
Tone Stith - "Something in the Water" ft. Maeta
​umru, Tommy Cash & 645AR - "check1"
Yo Gotti - "For the Record"
Zack Fox - "fafo"
10/2
Luh Soldier - "Too Easy (Remix)"
10/4
Alejandro Sanz - "Bio"
Arca & Sia - "Born Yesterday"
Catalyst Crime - "Cognitive Dissonance" ft. Jake E
Tasha - "Sorry’s Not Enough"
10/5
Eminem - "Venom (Remix)"
Jesse McCartney - "Selfless"
Magdalena Bay - "Hysterical Us"
Mitski - "Working for the Knife"
Porches - "back3school"
Tainy, Bad Bunny & Julieta Venegas - "Lo Siento BB:/"
Woodkid - "Iron 2021"
10/6
​​Alewya - "Play"
AXL Beats - "Motorbike" ft. Jackboy
bbno$ - "yoga" ft. Rebecca Black
Big Thief - "Change"
Bonobo - "Rosewood"
Cold Hart - "ALL I HAVE TO DO (COVER)"
Dax - "40 Days 40 Nights" ft. Nasty C
FBG Goat & Future - "Aerobix"
Grafh & DJ Shay - "Valid" ft. Ransom & Sheek Louch
Jugg Harden - "Hellcat Demon (Remix)" ft. Babyface Ray
Kandia - "The Flood"
Kylie Minogue & Years & Years - "A Second to Midnight"
Lil Darkie - "TRAP METAL"
Masego, JID & Big Boi - "Garden Party"
Miraa May - "Go Girl" ft. RAYE
​nothing,nowhere. - "Pieces of You"
PinkPantheress - "I must apologise"
Pouya & Denzel Curry - "Wig Split"
Tame Impala - "Breathe Deeper (Remix)" ft. Lil Yachty
Tank and the Bangas & Big Freedia - "Big"
Why Don't We - "Love Back"
​will hyde - "fukced up."
10/7
CeeFineAss - "Bitch Shut Up"
Cordae - "SUPER"
CXLOE - "Close"
Dylan - "MOSHPIT" ft. SSGKobe
Epica - "The Skeleton Key (Omega Alive)"
joan - "so done"
LightSkinKeisha - "Margarita"
Lil Wayne - "Ya Dig"
LMB - "QAMS" ft. Fivio Foreign
Naïka - "Don't Lie"
Nas - "Big Nas"
Paris Shadows - "Gone Girl"
SahBabii - "Switch"
Tears for Fears - "The Tipping Point"
Tom Walker - "Something Beautiful" ft. Masked Wolf
WSTRN - "Professional Love"
Yeule - "Don't Be So Hard On Your Own Beauty"
Young T & Bugsey - "Big Bidness"
10/8
24kGoldn & Lil Tecca - "Prada"
Aaron Cole - "FRONT ROW"
Anfa Rose - "SILK ROAD"
Artz, Bugy & Freddie Gibbs - "War Time"
BIGBABYGUCCI - "Cross My Heart"
Bobby Fishscale - "Role Models" ft. Kalan.FrFr.
Bobby Wills - "Pretty Good Tonight"
COIN - "Chapstick"
Conway the Machine - "Piano Love"
CRIM - "KILLING ME"
DBangz - "100 Million" ft. Elle Vee
DC The Don & jetsonmade - "REROUT3"
Dead by April - "Anything at All"
Dua Saleh - "​fav flav" ft. DUCKWRTH
ELIO - "TYPECAST"
FLETCHER - "girls girls girls"
Grace Davies - "roots"
HONNE - "BACK ON TOP" ft. Griff
Jake Owen - "Drunk On a Boat"
James Ivy - "Pushin' Thru It"
Jeris Johnson - "FRIDAY" ft. Trippie Redd
Jesy Nelson - "Boyz" ft. Nicki Minaj
Joyner Lucas - "Late to the Party" ft. Ty Dolla $ign
Jucee Froot - "Could Never"
Keedron Bryant - "Hello"
Keith Sweat - "Can’t Nobody" ft. Raheem DeVaughn
Kelis - "Midnight Snacks"
Koffee - "West Indies"
Lauren Jauregui - "Colors"
Lauren Jauregui - "Intro"
Like Saturn - "cold embers"
LP - "Angels"
Luh Soldier & Zaytoven - "DOA"
Måneskin - "MAMMAMIA"
Mark Barlow - "Waterfall"
Martin Garrix, Julian Jordan & Tinie Tempah - "Diamonds"
Michael Dion & Rick Ross - "Can You Hear Me Now?"
Mick Jenkins - "Contacts"
Nardo Wick - "Who Want Smoke? (Remix)" ft. G Herbo, 21 Savage & Lil Durk
NLE Choppa - "Another Baby OTW"
Oliver Tree - "Life Goes On (Alok Remix)"
Rasandra - "In Too Deep" ft. Lil Tjay
Ritt Momney & Shane T - "Sometime"
RuPaul - "Blame It on the Edit"
Russ Millions - "6:30"
Santino Le Saint - "Best Day of My Life"
Santino Le Saint - "One More Night"
STARSET - "EARTHRISE"
Strick & Swae Lee - "Play Stupid"
Sumo Cyco - "Sun Eater"
Teejayx6 - "My Interview"
Tone Stith - "I Don't Wanna"
Transviolet - "Everything Everything"
Tyla Yaweh - "Hands Up" ft. Morray
Unlike Pluto - "We're Screwed"
Yungeen Ace - "Duffle Bag"
10/9
Demi Lovato - "Unforgettable (Tommy's Song)"
Kodak Black - "Killing the Rats"
Lil Nas X & Jack Harlow - "INDUSTRY BABY (EXTENDED)"
10/11
Bryan Adams - "So Happy It Hurts"
Jeff Tweedy - "C’mon America"
Slimelife Shawty - "Suit Me Up" ft. Lil Durk
The Murder Of My Sweet - "A Ghost of a Chance"
10/12
Anson Seabra - "Keep Your Head Up Princess"
Cate Le Bon - "Running Away"
Elton John & Dua Lipa - "Cold Heart (Acoustic)"
Foolio - "List Of Dead Opps"
George Alice - "Mid Years"
Joy Crookes - "Trouble"
Lucki - "New Drank"
Matt Citron - "Wanna Go"
Santana & Chris Stapleton - "Joy"
​serpentwithfeet - "Down Nuh River"
Shamir - "Gay Agenda"
Suki Waterhouse - "Moves"
Suki Waterhouse - "My Mind"
Temperance - "Breaking the Rules of Heavy Metal"
10/13
2Win - "ROCK OUT" ft. Young Nudy
Aesop Rock & Blockhead - "Jazz Hands"
Barrie - "Frankie"
Blacc Zacc - "Dirty Money"
Chrome Sparks & Reo Cragun - "Blood"
Cold Hart - "Breathing In Dust"
Courtney Barnett - "Smile Real Nice"
Fickle Friends - "Alone"
Foxes - "Dance Magic"
Jesswar & Erica Banks - "BAD LIKE RIRI"
Julia Michaels - "Just One Look"
Lennon Stella - "Fancy"
Lila Drew - "2023"
Maxo Kream - "GREENER KNOTS"
Orion Sun - "Concrete"
SASSY 009 - "Red Plum"
Snail Mail - "Ben Franklin"
The Lumineers - "BIG SHOT"
The Wanted - "Rule the World"
Trap Manny - "Tap Out" ft. A Boogie wit da Hoodie
YNW BSlime - "Citi Trends" ft. NLE Choppa

10/14
88rising & BIBI - "The Weekend"
Anitta - "Faking Love" ft. Saweetie
AURORA - "Giving In to the Love"
Chase Atlantic - "ESCORT"
CHRIST DILLINGER - "Hall of Fame" ft. Lake Kyle & Lil Darkie
Damon Albarn - "The Tower of Montevideo"
James Morrison - "Who's Gonna Love Me Now?"
Kito - "Skin & Bones" ft. Winona Oak
Lil Migo - "Rumors 3"
Lil Reese - "Show Us Some" ft. Young Dolph
Mariah Angeliq - "Diablita"
Pa Salieu - "Bad" ft. Aitch
Pablo Alborán, Aitana & Álvaro De Luna - "Llueve Sobre Mojado"
Paulina Rubio - "Yo Soy"
ROMderful - "LEMME SHOW YOU?" ft. CJ Fly
Saya - "SICK"
Shafik - "Dulce Veneno"
The Wombats - "Ready for the High"
Tom Morello - "The War Inside" ft. Chris Stapleton
Tori Amos - "Spies"
Vera Blue - "Temper"
Westlife - "Starlight"
Wynne & Christo - "Carrot Cake"
10/15
Adele - "Easy on Me"
Allison Ponthier - "Late Bloomer"
Alok & John Legend - "In My Mind (Joel Corry Remix)"
Bad Gyal - "Flow 2000"
BENEE - "Somebody That I Used to Know"
Big Wild & Surfaces - "Awaken (Feel Alive)"
Billy Porter - "Children"
Blaze Gee & Benny the Butcher - "The Game"
Brasstracks & Tori Kelly - "Still Life"
Brian McKnight - "Faithfully"
Chloe Lilac - "19"
Cottontail - "My Bloody Valentine"
Derrick Milano - "Control" ft. Ty Dolla $ign
Dixie - "The Real Thing"
DreamDoll - "You Know My Body" ft. Capella Grey
Dua Lipa - "Love Again (GARABATTO Remix)"
Eric Nam - "I Don't Know You Anymore"
Fat Nick & Lil Jerry - "Park It"
Feby - "Shittin' Me" (Ft. Soulja Boy)
Gavin James - "Greatest Hits"
HARLOE - "PWR RNGR" ft. Mick Jenkins
Hayden Forbes - "SnowBanks" ft. Tabita Rotondi
Hotboii - "All the Opps"
HYYTS - "Singing Your Name"
ILLENIUM & Thirty Seconds to Mars - "Wouldn't Change a Thing"
IV JAY - "Got Me Insane"
Jay Hills - "Certified"
JBroadway - "My Humps (JBroadway Remix)" ft. Black Eyed Peas
JPRO - "FOTG"
Jubël - "I & I"
K.Flay - "Nothing Can Kill Us"
Kap G - "BnB" ft. Kap Chefcookitup
KA$HDAMI - "Intermission"
Kevin Ross - "Sweet Release"
Key Glock - "Da Truth"
Kygo - "Undeniable" ft. X Ambassadors
KYLE - "Sunday"
Lamont Holt - "Money Shake (Remix)" ft. ppcocaine
Lauren Jauregui - "Scattered" ft. VIC MENSA
Liam Tracy - "24/7" ft. Fivio Foreign
Lil Durk - "Pissed Me Off"
Lil Zay Osama - "If It’s War"
Matt Ox - "GO"
Meghan Trainor - "Rockin' Around the Christmas Tree"
Miranda Lambert - "If I Was a Cowboy"
mol$ - "yokai" ft. DEADIFY
Noa Kirel - "Bad Little Thing"
Phora - "Love Letters" ft. Skye
Pink Sweat$ - "I Feel Good"
Ray Dalton & Alvaro Soler - "Manila"
Ricky Montgomery - "Sorry for Me"
Sada Baby - "Super Smash Bros" ft. Mak Sauce
Sam Feldt - "Call On Me" ft. Georgia Ku
Sam Fischer - "Hopeless Romantic"
Sea Girls - "Again Again"
Slump6s - "Origin"
Spencer Sutherland - "Lemons"
SpotEmGottem - "Killers on They Shit"
Stromae - "Santé"
Suigeneris & BabySantana - "Milan"
Summer Walker & City Girls - "Ex for a Reason"
Steve Aoki & End of the World - "End of the World"
SVDDEN DEATH - "Transmutation Sequence"
Tusse - "Grow"
Two Feet - "Don't Bring Me Down"
Unlike Pluto - "Perfect Season"
Vargas & Lagola - "Ain't Leaving Now"
VRSTY - "Finesse" ft. Notions
Walker Hayes - "U Gurl"
WeiBird - "Cheap Love" ft. Ben&Ben
wifisfuneral - "No Debate"
ilycrisis - "Cry" ft. yvngxchris

10/16
Kodak Black - "Who Want Smoke (Remix)" ft. Chief Keef

10/18
Coldplay & BTS - "My Universe (SUGA’s Remix)"
FL Dusa - "Dusa" ft. Kevin Gates
Jack White - "Taking Me Back"
KAWALA - "Searching"
Majid Jordan - "Forget About the Party"
Matt Ox - "TAP DAT"
Queens Cast & Brandy - "Hear Me"
Queens Cast, Eve, Naturi Naughton, Nadine Velazquez, Brandy & Pepi Sonuga - "The Introduction"
Soldier Kidd - "Thug Paradise 2 (Remix)" ft. NoCap
Trippie Redd - "GO CRAZY"
10/19
Bastille - "No Bad Days"
Blakk Soul - "Shake"
Money Man - "Tip Off"
Parquet Courts - "Homo Sapien"
TOPS - "Waiting"
10/20
BJ the Chicago Kid - "Smooth"
Bonobo - "Tides" ft. Jamila Woods
Comethazine - "Six Flags"
Culture Jam & Capella Grey - "Bestie" ft. A Boogie wit da Hoodie
Duran Duran - "GIVE IT ALL UP" ft. Tove Lo
Hope Tala - "Tiptoeing"
Lights - "Prodigal Daughter"
MARINA - "I Love You But I Love Me More (Remix)" ft. Beach Bunny
Obongjayar - "Message in a Hammer"
Of Mice & Men - "Fighting Gravity"
SahBabii - "Teacher"
Wet - "Bound" ft. Blood Orange

10/21
Angèle - "Bruxelles je t'aime"
Arch Enemy - "Deceiver, Deceiver"
Digga D - "Red Light Green Light"
Dreamer Boy & BENEE - "ARE YOU LETTING GO?"
HEALTH & Poppy - "DEAD FLOWERS"
Joel DELEŌN - "La Culpa"
Josef Salvat - "The Drum"
KABBA - "Mood"
Kailee Morgue - "Butterflies"
KayyKilo - "YEAH BITCH" ft. DaBaby
Nick Mono - "All That You Do"
Rage of Light - "Lead the Riot"
Sevdaliza - "Homunculus"
Shallou - "High Tide"
Steve Aoki, Jolin Tsai & MAX - "Equal in the Darkness"
Wiz Khalifa - "Million Dollar Moment"
10/22
2KBABY - "Luigi" ft. Chief Keef
A.CHAL - "Zorro"
ABBA - "Just a Notion"
Alexandra Stan - "Tokyo"
Ally Brooke - "Mi Música"
Aly & AJ - "Am I Alright"
Aries - "ONE PUNCH"
Autumn! - "Portrayal!"
Ashnikko - "Halloweenie IV: Innards"
Ayo & Teo - "Stop Drop Roll"
Battle Beast - "Master of Illusion"
Benny Benassi & Ne-Yo - "Let Me Go"
Big Sean & Hit-Boy - "What a Life"
Bobby Fishscale - "Own Eyes" ft. Mozzy & Ink
carolesdaughter - "my mother wants me dead"
Cavetown - "Teenage Dirtbag" ft. chloe moriondo
Charlotte Cardin - "Scorpio Season"
Chief Keef - "like it's yo job"
Christina Aguilera - "Pa' Mis Muchachas" ft. NICKI NICOLE, Nathy Peluso & Becky G
CMTEN - "I'm Going to Cedar Point"
Cozz - "Fortunate"
Craig David & MNEK - "Who You Are"
Dean Lewis - "Looks Like Me"
DJ Snake, Ozuna, Megan Thee Stallion & LISA - "SG"
Gabbie Hanna - "Happy (In the End)"
Gracie Abrams - "Rockland"
IAMJOSHSTONE - "Slide 101" ft. Dave East
Jada Kingdom - "Jungle"
James Arthur - "SOS"
JayDaYoungan - "Red Flag"
Jordan McGraw - "McConaughey"
JPRO - "Sheesh!"
Justin Tyme - "Chase" ft. Canibus, Kool Keith & MF DOOM
Kendra Jae - "BIG"
​keshi - "SOMEBODY"
Khalid - "Present"
Kiana Ledé - "The Christmas Song"
LÉON - "Soaked"
Lil Texas & Kayzo - "Need You"
Lil Tjay - "Not in the Mood" ft. Kay Flock & Fivio Foreign
Lil Xxel - "Wishlist"
Matt Ox - "TAKEOFF"
Melladaze - "I H8 U"
Mick Jenkins - "Scottie Pippen"
Miles Kane - "See Ya When I See Ya"
No Rome - "When She Comes Around"
Nuski2Squad - "Letters & Designer"
Ola Runt & Yung Bans - "Most Days"
Pink Sweat$ - "Nothing Feels Better"
Projexx - "Sidepiece (Remix)" ft. Ruger
PVRIS - "My Way"
Quavo & Yung Miami - "Strub Tha Ground"
Ransom, The Game & Rome Streetz - "Pray for the Weak"
Sabrina Carpenter - "Skinny Dipping (Acoustic)"
Sean Paul - "Dynamite" ft. Sia
Sematary - "REDWOODS" ft. Hackledown & Hackle
Swedish House Mafia & The Weeknd - "Moth to a Flame"
Tokio Hotel - "Here Comes the Night"
Tom King - "Honest"
Tove Styrke - "Start Walking"
UnoTheActivist - "Make It Make Sense"
Vella & Macy Gray - "Blue"
wifisfuneral - "Demons and Wolves"
yvngxchris - "bitch im joe biden"
10/24
Matt Ox - "Universal"
10/25
Aminé - "Charmander"
Katy Perry - "All You Need Is Love"
Queens Cast, Eve, Naturi Naughton, Nadine Velazquez & Brandy
- "Belly of the Bitch"
Queens Cast, Brandy, Nadine Velazquez, Eve & Naturi Naughton
- "Heart of Queens"
Queens Cast & Brandy - "Wrecking Ball"
10/26
Ad Infinitum - "Animals"
DavidTheTragic - "ANEMIC" ft. Kenny Mason
Emeli Sandé - "Look What You’ve Done" ft. Jaykae
Kevin Gates - "Dear God" ft. Dusa
Matt Citron - "Squeeze Pressed"
Shygirl - "Cleo"
10/27
Beach Bunny - "Oxygen"
BJ the Chicago Kid - "6 Months"
Eli Fross - "Mad Max" ft. Lil Zay Osama
fish narc - "Instant Sobriety" ft. 8485
Gabi DeMartino - "Immaculate"
iamjakehill - "I Chose Violence"
JessB - "From Tha Jump"
Kasabian - "ALYGATYR"
Kenny Mason & SKuFL - "​stevie can see"
Lonely God - "Marlboro Nights 2" ft. midwxst
Marian Hill - "omg (Remix)" ft. Reo Cragun
Metronomy - "it's good to be back"
MICHELLE - "MESS U MADE"
NEFFEX - "MANIFEST IT"
OSTON & Lauren Sanderson - "Lie About You"
Quando Rondo - "Time Spent"
​reggie - "Traffic"
Smrtdeath - "Misfit"
Snail Mail - "Madonna"
Wande Coal - "Come My Way"
Wiley from Atlanta - "ALIEN GIRL" ft. Tom the Mail Man

10/28
A$AP Ferg - "Green Juice" ft. Pharrell Williams
Allan Kingdom - "Breathless"
Asiahn - "We Can"
BENEE - "DOESN'T MATTER"
Daniel Novello - "BLUE" ft. Fontana & Tom the Mail Man
Derez De'Shon - "All Them Days" ft. Morray
Drippin So Pretty - "Terrified!"
Faouzia - "Puppet"
Imagine Dragons & JID - "Enemy"
Kyla La Grange - "Neverland"
Lancey Foux - "BIG SWAG" ft. 24kGoldn
Nightly - "Lose My Number"
ODC - "Devil in Me"
Slimesito - "Free Fluhkunxhkos"
10/29
44phantom - "I WON'T COMPLAIN" ft. Tom The Mail Man
Ama Lou - "Trust Nobody"
Amy Allen - "End of a Dark Age"
Anjelica & RMR​ - "Haystack"
ayokay - "All Mine"
Azealia Banks - "Tarantula"
Azealia Banks - "Wings of a Butterfly"
Baby Tate - "PEDI"
Babyface Ray - "Catch It"
BabySantana - "Patricia"
Bhad Bhabie - "Bi Polar"
bLAck pARty - "Lay (Season 5 Version)"
bLAck pARty - "Soakin" ft. Gwen Bunn
BlocBoy JB & Tay Keith - "Day Day N Craig"
Blueface & Justina Valentine - "TikTok (Remix)"
Bobby Shmurda - "Cartier Lens"
BoyWithUke - "Toxic"
BRS Kash - "I’m Hot" ft. Chi Chi & Nick Papz
Calboy - "If Heaven Had a Phone"
Carlie Hanson - "Snot" ft. Deb Never
CEO Trayle - "Ok Cool (Remix)" ft. Gunna
Cheat Codes, Lee Brice & Lindsay Ell - "How Do You Love"
Conan Gray - "Telepath"
Crooked Colours - "Light Year" ft. Masked Wolf & Jasiah
Cypress Hill - "Open Ya Mind"
David Guetta - "Family" ft. Bebe Rexha, Ty Dolla $ign & A Boogie wit da Hoodie
DC the Don - "Arrest Me"
DJ Chose - "Trying" ft. Yung Bleu
deadmau5 - "Hyperlandia" ft. Foster the People
Dread Woo - "True Blue"
Dro Kenji - "VANISH"
FBG Goat & Young Thug - "Private Phones"
Flo Milli - "Ice Baby"
Florrie - "Communicate"
Fredo Bang - "Many Men" ft. JayDaYoungan
French Montana - "I Don't Really Care"
FRENSHIP & Lauren Sanderson - "Try"
grandson, Kesha & Travis Barker - "Drop Dead (Remix)"
Hotboii - "Never Say Never"
INNA - "Up"
J.I the Prince of N.Y - "Taken For Granted"
James Blunt - "Unstoppable"
Joel Corry & Mabel - "I Wish"
John Mayer - "Last Train Home (Ballad Version)"
Johnny Orlando - "You’re Just Drunk"
Joyner Lucas - "Duck Duck Goose"
Jucee Froot - "Could Never (Remix)" ft. Moneybagg Yo
KBFR - "BooHoo"
Key Glock - "Toolie"
Kylie Minogue & Jessie Ware - "Kiss of Life"
Like Saturn - "time and time again"
Lil Gnar - "Skelly"
Lil Peep - "halloween" ft. rainy bear
Lil Poppa - "Missing Something"
Lil Uzi Vert - "Demon High"
Lil Xan & $teven Cannon - "Ha Ha Ha!"
Lil Zay Osama - "Roll Up Hot"
Macklemore - "Next Year" ft. Windser
Maggie Lindermann - "She Knows It"
Mahalia - "Roadside (+234 Remix)" ft. Rema & Ayra Starr
Mario & Chris Brown - "Get Back"
Meduza & Hozier - "Tell It to My Heart"
Mike Posner - "Amor Fati"
Myke Towers, Camila Cabello & Tainy - "Oh Na Na"
Neon Trees - "Holiday Rock"
NGHTMRE & Zomboy - "Shell Shock" ft. Georgia Ku
OG 3Three Never Broke Again - "Aquafina" ft. Luh Kel
Phora - "Romeo's Cure"
Poo Bear - "Distant Shore"
Powers Pleasant, Denzel Curry & ZillaKami - "EVIL TWIN"
Regard & Kwabs - "Signals"
S-X - "Who We Are"
Sabaton - "Christmas Truce"
Sam Tompkins - "Bloodline"
Savage Ga$p, Chevy & Ellise - "go bestie"
Scorey - "Catch Me If You Can"
Shontelle - "Sanctify"
Squash - "Cyaa Bruk Back"
​SSGKobe - "Caddy"
Sueco - "Sober/Hungover" ft. Arizona Zervas
T-Pain - "I'm Cool With That"
Tank - "I Deserve"
TeaMarrr - "Show Me Love" ft. Meer Colon
Thouxanbanfauni - "Off The Lot" ft. UnoTheActivist
Vance Joy - "Fairytale of New York"
VÉRITÉ - "Teenage Dream"
WhooKilledKenny - "Tweakin’"
Why Don't We - "Love Back (Stripped Back)"
wifisfuneral - "Resurrection"
YG - "Sign Language"
Yung Miami - "Rap Freaks"
10/30
Now United - "Future Me"
She Won't Live - "Gritty"
10/31
Delorians - "Needy"Embed